1313111233311333113312321102111121310231211331131111331301122220023111321101311311131131331321300133
1011311112311121331223121301312231312111111332331131212233212112211312113111121111032123311111031231
1320111321131301112111120311121231131113010111121313121110101131121321113112231221122102111321111211
1211121112111111223013131323330321133113101122121111012300230132231111111103112101112011310011112301
1130122112230021112031111212120311311331011121121311132223123031211313021113012113010010232212101223
3021201121331122211113211112023101120111211111133010121112120030132201201123211321223212010321111031
1110112121312122131312221213012311212333033111101120132301013311211321113302231332223310113321133122
1102113211013113230111131101131111111122302131011111121102323232111021311111101133111113010012112311
1102311111131111103210212001011121110031233011111023211333121311311211211232322133121210121111111011
2020111113102311110311312221111320211113313100120212323213111113201111011111121313223223322113210131
1301112011111301111110311111322132131110213311331211111101211013331123131323221311211111111113211113
1121100231112311113133311332131232202133102211010133111311122031221131121010310231012011113111121122
0111133223211123112333321232221131323331111122311311331012131132111323133301221233133321112131321211
1130111033031111131313121130331011211121231311312310323202201130201110312120311111133213211132111211
1133113131113103123123111011301221011321122320320121121011132321313122331111033313131122301021301211
1111113101112131011312120131223211312111303313101121132031211111311120133131101030221212023111132123
1312130122323132230113111311210011311231001112321130331211121111130301111111022110213130222221132011
1130212213123222222111110331111320131312122213321112310133122212321313131110223113103221213011122321
1113111110000200131013321121111321100131310212130032023123123121133111213321021231321103122221012101
1313311321112113311121111100221122121331111112332321123112011220121112113213101111231132301210123110
1011332232131011111222322321123121221111102112201112222013211111131213101221231311113213110012211111
1311110312113111001112113121202322131212113313213301211111101322211121001123131321132111112111211103
3131113121111121121003232122113213321303111321013131102120313103122111123313311103111001111112111131
1211131112101111211231231213102112101211010211212113232330132121311323111121100121111131131131113101
2203321103113331223131302031131112233103321212313301111232121121211311221121320221121111111113311112
1303123131210233211113103231311113311111331111111111213133111022123211212011223231132231202121123213
1130213200113132111311321311233111313111101301211222132310223321311111033311121010332111213101221101
3233122122111311111312210313131122131301122110111213022131013131311311211113231312331101221113003213
1310022213312313333131221031232021010133132212232112011311112131033121232032031111313202211232202113
2111112311000312111200101120111111122222110231113211113112213231103312111111031112113113301021110331
3100012101111233331122101131110100101201111110313311312221111311321113112313110101201223112111311111
1322231031212331323311011330033332211111301332201123122213212321121112031122132213111112130112221121
1120320010113101110101013333111113211122111031112113123031132201103131232121131123112022211111121302
3010111311111113311321132211101111131113111211321011320321111221331213231221310131221103100321321110
2010112211113012110223323113131111123112323110012131333121111322312121302113111013112211113313111223
3112112232223221213222101011211321131112210113113111220001113103122131133331113033112111031110123131
3311132123031331021111011313112103132303103002011011311103321233223111131213322102310111131111211113
3010211102011211130131311232222131321133122121223111121113133323212011132110110010111112122102132203
1132111212112333121321130111111101111132211011213302330112122131310111231111221303111323011213103231
0231311123113323112102123333231131231131122021201121113113213322212100121312020210101211330132011233
1212123033212310131312313233211121212212122311201123212222133233111131112031321202221210111112211113
1111221132111331121111211113111321121303111212123213202112131112311330010133010021112333332333211111
3111111211133132333301213213112311111111311112111113110131312333112311121111120111011130212212211222
2211101311200112233111112323111311211123111311321113002332111321113113001132313133111112122123131121
1321311131113323031211221131111303211222113312111120101311133321331031123320111231013121121211121001
2111011331223011213321111131111311321313202031131010331112111132011131330110321113112312112112131021
3210110312313111201331121310132213132131112121133211131121112113112212130212302111233103321232023111
1011022133321311111211221110321311301231112020021312112211121312211322131111131121111111302111210312
2211021103221121133123211322111331231302111212221212212332111113111013311101111221210110101211111113
1111212121111101322021023123110113011211111133123211311122211101131231111211312101101221111211312120
1122121112201321312131211131101311113231211333021131113111223120121101111023233130121121011100311111
1213111313133332113201112011112312102031111311010022113110311132101022132223023111213113131221232131
3213231121111132101220210221111121103321111111111310113333033311333312323233111131133131201111312021
1122231111211030313011232111113110113113211311123131102113121121011213013301111321231112311113133121
2222110301212112111011020213111303113213213322112011210113111233111033333111113322212311311123111111
3110231311131132322111110111212020111131221131332111110113121213122120332123321203133111120110121111
3112311121213122110103111331110110113121101321122313110122101111313111131012221112123113112110112101
1110121121132112122123231012111001011113010313312220221101213232311102100111133121313032011111311111
2221023112321211111332311113011221123123311231111131133102111101111120031031313111102121113122122213
2030310311210011133101111122132311220231131111010123111000111221130111111210211231311331301003310231
1130113220311133310101201213112021122131121033231211211111111301113012103330011233102112131133311110
3112111100100201201122210313312133111111111123211123322131211111122312021110312113232301031131211113
1311111111111311112210122111111101131113013111213220131121013133111111011311121111231112100111111012
1113010021033111011213212313212111223111103003010211111112311121211311111032311211111321211012311321
1311102232211103303121011221111121111211111131301231323131210312111113111211113110031311123101313213
0322311122333303320213113311123032311311110112121111102122311110111123331012111111110031113133111131
1103322132111111123300321111211231112301112101112221121111231132221312131313223011212030131123011110
1112111110131211101011101122031010013331121131111111212221132311013212102123111313123112210011221312
1311111123113120113120011330113102202131213211111111120232110130231211131111132312120123310310133301
3231123131223112020102323103100122121110102113231122110331323333132111002331022122111111302221111111
3133031221311131211121111120110010001312111230121132031311231121011011113111233111133211110211232031
0110120101312311131112031112122120221221231111312212202111200111133111131311211012111121331331210322
3221113132312222100132101213231213111110012011111101111201001112313211101311101130102131301112112030
1110222331032231331133031111112212131210302111111321312331011212331321222212111121212111011101211101
3113210211111331111211133100131131311221123221213213113211312231211113201311312211111112122211211211
2111133113313313211132131301111201211221111111131111112211221221001211201131111331123111020112313132
3211331013121011131111321313111033103011212201122102203111223221101310131112131123202211131011111200
3332222212123101133111121321113100222101011133121111133121323311231331111121221230121101110311130212
1033111121011111123112120313221111111211010213011131313003212111311313123131011103221303132233230111
1312111312121211121112111231113211111212030131201103220302113222111231201313311311130111111211222223
3121111311312211112102120111033120111122311102122101123212131011221110111110312112111311121131112212
2111110111110121310003301111303221303321111331122112010013111111112302100110113112133232033213113121
3101231113131113231112131121112210333321111313131231311113131233112121121131230131113111331213113123
1111113212100321111232110120211230112213112121003211123110003111112122220312301200232113003313113313
2133132312331101110313111132211131132212321111021021222113211111011103212221231111121311211112130131
0110312011131111211101202101111113011211013301321113113011111111131111131333213310233211201321310123
1131011112111301112110311022213211123311333211132311033111111011111312111313120121131111100211121313
1333230113312311233113113131110212102111111213312100311211010110133212111001211123211121102031221121
1001322113311213110112210122212223112121121121211110111332321122103222221131112211101213111011132121
1111311121311023223121100331020111321231313212302113211011131112112323131013301120002113020321311023
1110113121122231310111122213121311112332111123320211310233332111111122121312111110120231330130311302
1023311231111311121221211211110111112111011112103111311121332312112321121132111112210231321131302131
1220213231221303232113111111311121130131012111121301211111122113212132112210023133112222030111322011
0111212311131112323310331211102312113223313110131213113331111132212231311131110202103122121120131111
1112112213312111111111111311111010123131213131113322113213111111121231111101030012210211121133233232
1332211003113121011111011112331132311310111222113120311333222120011101133321311221202121013131123111
0120111101311001210112121322311302112200113132132131131211111333122121313122122121102321122123102112
1310111331113111212211311123132102113331112111323113033301123132221112011112311201121112111121332112
1121010131312111132313211101110110121021313112222331011201322131121322111312313301113311132132110111
1122211321310002132132222331122223203211231111311110123123333202213113231131112131232211211311213011
