NBNNNNTBNBTNTNNNHNHNTTHTBNNTHBNTNTNNHNNNNTNTHHNBTTNNTNNNTNNNTBHTTHBNHBNNHNNNNTNTNHNBNNTHTBTNNNTNHNHN
THTHHTTHTNHHNHHHTNNTNNTNNNHTNTNNBNNNTTNNNNNBNNTNHNNNBHNNNNNTNNNNNHHNHHBHNBHBNHTTNNTNNHNTHBNTTNTNNTHN
NTNHNNHNNTBNNNBNNBHTNNNHNHTHHHNTHTBTNNTNNNTNTNTNTNHHTBNNNNNHNHNNBHHHHNNTNNTNHHTNHHTHNNNNHBNNNNTHNBNH
TNNNHNNHNNNTNNTTNTNHNBNBNNNNNNNHTNNHHBNNHNNNNNNNHNBHNNHHNNHTNTNTNTNNTHNTBNNTNTNNBHNTNBTNNHTTNTNTTHTN
NNNNNNHNNBNNNNNHNNNNTBNTNBTNNNBBBBNNNTNNHHNHHNNHTNBNTHNNHTNNBNHNTTHNHTHNNTNNHNNTHNNNNHHNNNHNBNNHTNNH
THTBHNNNHBHTTNNNHNBNTBTBTBHTNNNNHNHNTTHNHNNHNNTNTTNTNBNBNNNNTHNTTTNNTNNTNBBNBNNTNHNTNNNNTHNBHHNBNTNN
THHNNNNHNTTNHNTNTNNTNNHHTNNNNNNTNBHBNBBTHNTNHNHNBTNNNNHNHBHBNTHNNTNNHTNNBTNNNNHBHNHNNNNNTNBTHNNTTHTN
NHNHTHNTNNTNNHBHTNBNHHHBNNNTNTTNHTBHNNNTNTBTNBNNNHNHNNNNHTNNNNNNHNHTBTBHHNTNTHNBNTNNNNBTNNHHNNNHBHHN
NHBHTNHNNTNTNNNBNHNTTNNTNHNNHHNNNHHNTNBNTHTTBNBTHTHNNNNNNNTNNNHNNNNHHTNHBHTBNNHTNBNNNHHHNNBTNTNNTHTB
TTNTHTBNHHNNHNBHNNHNHNBNNNTTNNHNTNTNNNBNTNTHHNTHNNNNNBHNBHTHNNTTNTNNNNNBNNNHNBNNNHNNTTNNNHHNTBTTBNNH
NNHNBNBNHNNNHHNBNHHBHTNTTHBNNTNNNTNNHBBNTNNNNNNHNNTTTNNTNNNNNTTNTBNTHNHBNNBNTBNNNNTNTNBBTBTNNNNNNNNT
NHNNHNTHNNNHNNNBBBNNTNNHNNNBNNHNHNHNTHHNTHNNHHNNHHNNNNNNNNNNNTBNHNHNNTTNNNTNHNHNNTNHNNNNNTNBBHNNNNNN
NNNBTNNHTHNHNHNNNBNNNHNNHHNHHHTTNNNBNNBNNTNNBTNTHTHTHNHNNNHTTNNHNNBHBBTHHNTNTHNTNNBNNHHTHTNTNTTTTNNN
HNNNHBNBNTNNBNHTNTTNNTNTNHHNNHNTNBHTHHNHNNTTNHNNHNBTHTNHNNHTHNTNNNNHNNNNNHNNNNNHNNNBTNNNHNTTTNNNNNHN
NNHBNHTNNTNNNHBNNNTNNNNNHNNNTNNNNNHTTHTNNNNNNNNTNNHNNNNNNHNNNBHBNHNTNNNNNNTBNNNNNNTNNNHNBBNHNBHTTNNN
NHNHTNNBTTNNHNNNNHTNTNTNNNNNTNNHTNNNNNHNNNTNNTNHHNBNNNNTNNTNHHBTBBBNBNNNNNNNBTTBNNHTNNNHNNNTNNNTHNTH
NNBNNTNNBHNNTNHHHNNHTNHTHTNTTNHNHHNNNNNNHHHBHNNNNHBTTNNNHBBNHTNNNTNTNNNTHTNTNNNNHNNTNHNHBHTNNNHTHNNT
NNHNHNTBNNNNNTTTNNNNBNBNNTNHHNNNNHNNNHNHHNHTNTNNBNHTNTNTTTHHNNNHNNNNNNNNNTNBNTTTNNHBNTBNNNNHNNBTBHNN
NHBNBBHTNNNBNNNNNNNNTTNNNNNNHNNNNNNBHBHNNNNNBNNNNHHNNHNTNNNBNNHHBNNTBNBNNBHNHNHNTNBNHTNNTNHTTBNHTNBN
TNTHHNTTNNNBHNNNTNNHNNNHNBNNTTHTHTTNHHTNBNHBNTBNNNNNNNHTNNNNHNHNBNNBNNNNTNNNHBBNHNNBTNNBTNHNNNNTHTTN
TTBNHNHTBTBNNNNNNTHNHHNHNNHTHBTNNTHNHTTTNNTNNNNBNTNNNNNNNNNTNNHBNHNNTHBBTNBNNTNBHNNNNNNTTBNHTTNNNNNT
THNHNTNHBNHTNNNTTTTNNHNTNNHNNNTHTBHHNNNNNTNNHTBBTNTNTNNNTNNHNTHNTTHNTTNNNNHBNNTHNHTNNNTNNHNNHNNTTHBT
HTNNHBTNNNHHNHHBTBTTNNNNNHHTBNNHNHNNTNNTTTTNNNNHNNNNNHNNNNTNNHTHNTHNNNTNNBHTNNTNHHTTTTNNNNHHNNHHHNTT
NNNHTBNNHHBNHHTTBNTBTNHTHNBHNNNNNNBNBTTNNTTNNNBHNNNHNNNHHNTTHNNNTNHTHHTHHBNNHTTHHHBBTNHTTHNHNTNNNNHB
BNNBHNNHTBNNTNTBNNNNNBHBTNHHBTNBNNNBTNHTNNNHHHNNHBBTHTNHBNHHTTHNHNNNNTNTNHNNTNNNHBBNTHNHNHNHNHBBNNNH
NNNBTNTHHHNHNNNHNNNHNBBNTHHNNNTTHTTNNNBTNTNNNTNBNTNHHNHHBNBNHTHNHNTNNNBNTBNHTNTBNNNNHBBNTBNHNNHNBNNN
HNNBNTHHNBTTNBTNHNNBHTNTTTNTTTNNNNBHNHNTNBNNNHBNNNHBTNTNNNTHNNBHNNNTTBBNTBTTBHNNNNTHBHNNBNNTBTNTNTNT
NHNTHNNBNHBNHTNHBBNHTBNTTNTHHNNNNBBBHTHNNHTNNHHHNTNNTNNHNNHHBHHHTTNHNTTHNNNTTNTNNNNTTNNHTTNNNNNBBHHH
NNNTNTNNNNTHNTTTBNNNBNNNHNBTNHHNBHNTTNNNNNNNHBNNHTNNNTNBNHBBHHBNNBTNTBTNNHBNTHNTNHNBNTTNTNHBNTTNNHHT
TNNTNNNHTHNNHNHTNNHNNNNNHHBHHNTTNHHHNNHNTNNBNNHHBHNHNNHNTNBNNNNNBNNHNNNHTTNNNBNHNNNHBHTBNHNNNHTNBHNN
NTNTHHNNNTTTNNBBBNNBNNHNNBNTNNNHNNHTNNNNNTNTHTBHNTHHNHHHNNNNNHNTHNHNNNBNTTNNNTHNNNTHNHNNBNNBBTNNNNTT
NTNNHHBNNNNBNHNNBHNBNNNBNTNHNNHHNTTNBNBHTHNTBNNNTNNNHNHTTNNNNBHNNBHNNTNTHNTNNTNBNBNBNHHBTBTNHHHTTHTH
TTTTNBHNNTNHNNNNTNBHNBHNHNTNNNNHTTHHHTNNHBNTHNTNNNNNNHNTNTTNNHTNTTBTTNNNHNNTBNNNBNTNTHNNBBNTNTNHBHHN
NBNNHTNTNHBBHBBHBTBHNNHNTHNHNHHBBTHTNBHHBNNBNHHHTNBNBNNHTNNNNHTHNTTNHNBNNNNNNTBHTNNBNNBNHTHNHHNTNHTT
NNTNHNTNNTNNHHNNNHTNHTTNNHNBNTNNTNNNNTHTNTNNNTHNNTNTNNNNTNNTNNTNNTNHHNHNTNNNBTBHHNNTTHHNTNTNNBNNNNBN
BTNNTNTNNNBHHHHBHBHNHNBHTNBBHHTHNBNTHNTNHHNNNBTHNNHHTNBHNTNHNNHBNNNNTTNNNNNNHHBBNHNNHNHNTTHNNTNTHNHN
NHHHNNNHTNNNNHBTTTNNNNNTNNBNHNNBTTHNTHBNNNNTTHNTHHNNTNNBBNNNNNNNHBNTTNNHTBNBBNNNNHTBHHNNTHNNBHNHNNBT
HNTNTNNNNNNTHNHBTTTTHHNHTNNNBBHNNNNTNNHNTHNNTTNNBTHNBHNHBHTNNTBNTNBNNTTBNBBNNNNNBNHNNHTTHNBNNHNHNNHN
NHHHNNHTTNTNNBNNTNTHBNNBHTNNNTHNNNNNBNTBTNNNNNNTNHNHHHNBHTBHTTNHTTHNNNHTTBNHTHNNHNTHNTHHNTTNHNNHHHTN
NHNTNHHTTHBNNTNNTNNHNNHHHNHTNNHNNHNTNNHBNNBHBTHNNBNNHNBNNBNHBNHNHNNNNHNTNNHNNNNTNHTNHNBTHNNNNNNTTTTN
TNNBHNTBNNNTTHHNTHTNNBBNTHTHHBBBBNBNNBHNNHNTNHNBNNNHNNNBBNNNNTHNTTHNNBNHBBNHHNTNHNTTBTHNNNHHBHHNTNBH
TTNHHTHHHTTNHNTNNHHNNHHHNHTTNHNNNNNTHNHNBBNBNNNNBNNTTNHBTNNTTTNBNHHHHTNBHBHNHHNNBNNBTNTHTHBNNNTHTTTT
NBNHBNBHNNBNNNNNTTBHNTNTNHHNTTTTHHTNTTBNNNNNTNNBHNNNNTHNNNNHTNNHNNBNNTNHHNTNNTNNNNTTTBNNTTNBTHBNHHNN
NBNNNBNHTHTNNBNNNTNTNNNBNNNNHNTNNNTNNHHBBNNNTNNBNTNTHTHNHHTNHTTBNNTNHNNTNNNNNTNNNNNTHBNNHHTBHTTNNHTN
NNHNNNTBNHNNHHNHNNNTNHHNHBNNNNNHNNHNTNHNNHBBNHHNHBNBTNNHTNNNTHNNBNNTNBNTTNTTNNTHNNNNNTTNHNHHNHHTNNNN
NTTNTTTNBBTTHNNTBNNHNNNHBHTNNNBTNNNBNNNNBHHNNNNBTNTNTNBBHHNHBHNNNHHNTNHTNHHHNNBTNHTNNNNNNNBNTNBNNHNN
BHTNTNTNHNHTHTHBTHNNNTHNHNTTBTNTNTNNTNHTHNBHHTHNNTNBNNHTBNNNNHHTNNHNNTHHBNHNHHNNTNBHHNHNTHNNNHNNTTTN
NTNHHBNNNNNNNTBNNNBTHTHNHHHHNNHBTNTNNHTHNNBNBNNNTHTNTTBHHNHHNNTHNTBNHNNNHHHTNTBHNNNNNNNNNNTNHTNNNBNB
THNHNHHBTTTHNNTNNTNNBHTNNHHTNNTNNNHBNHBBHNHTTNTHHNHHHHBNTHHHTHHNNTNNNNNNNTHNNHHTNNHNNNNHNNNNTHHBNTTH
NNNNHHNNNNHTNNTTNBTHNNBNNTNNNNHTNTHNNBBTNTBNNNHNNTHHNTNHNHTNNNNHNTHNNNTHTNNHNNNNNNNNNNTTHNHNNNNNHHBH
NHNHHNTBBHNTNNNNNTNTHBNTHHNNBBNBNTNBTTNHHTHHNNNBNHNNHBNTTTNTTBHNHTNBHNTHBNHTNNHTNBNTTTHNTNNTNNTNHNTN
TNNNNTNTNTBTNTNBTNNTTNTNNNTHHNHNTHNNNHNHNBBNNHNHNNTNTTNTNBNNNHHBNTBHBNTBBHHTHHNNTNHHHNNNTTTNBNNNNBNH
NHNTNNBTNHNBTTTHTTBHNNHNHNBTHHBTNHTNNTBNNNHHNNNNNNNNNNNTTNNBHBNHNNBBTHTHNHTNNNTNNNNTBHNNTHNNNBNNTNHT
NBNNNTNHHTNTNHTHTTHHHTBNBNHNTNHBNNTHNTNHNNHHNNHNTNHTNNNNHTTNNNHNNNNHNHTHNTHBNNTNBNNHTBTNNNTHNNBNBTNB
HNTTHTNNTBTNNNNNNNHHNHNNNNHHNNHBBHBNNNHHTNNTNHNHTNNTNNTHTNHBTTTTHNNNNHNNTTHNNTTNNNNHBHHNNHNBNNHNHBTN
TNNHBNNNHNNNNTHTNBHNNTNTTTHNNNNNNNTTBBBNNNNTTHNTNHTHNBHNNNNTNNNHTNHTBTHNNNTNHHHNNNNNTNNTTNNNNNNNBNNN
TNTNBNNHNNNNNHNNTBHTHBNNBHBNTNNHNHNNHHNNNNTNNNHHNNNHNNTNTTNHTNNHBNNHNHHNTNNNTNTNNTHHNNNNNHBNNHNNNNNT
NHNNNNNNBNHHNTNNBNHBNNHNBNNNHHHTNHNTNHNNNBNBHHNHHNTNNBNTNNNNBNTHNTHNNBHNNBNNHBBNBBNTHHTNHNHTHNBNBNNN
HNNNNTNNNHNNBNBHNBNNHNNNNNBBTBHHHNHTHTNHBNHHNNTTNNHNNHNNNBHNNTHNBNNNNNNNNNNHBTNNNNNNNTNHNNTTNNHNNNHN
HNNNNTNNHHHTBNNTNTNHNNNNNNHNNHTTNNTBHTHNHNTHNHTNTTHTNNNTTNNBNTNNNNTTNTNTNNNNTTTTTBNNTHNNTTNNBNNNHNNH
NNHNHNHNNNBNTNNHNHBTHNHBTHNHNNBNNTHNBNTHHNHNHHTHTHTNTTNTNHHNNTNNTBHNNHNHBNTTNNNTNHNTTNHNNTTNBTBHBNBT
NNNNTHBHTHNHNNHNNHTHHNNNNHTNNNNHNNTNTTHNNNHBTHNNHNBBHTTTTNNNTBNNHNNTNBNNHBNNTNHTNHNNTTTNNHHNBHNBNNNB
NNTHNNNNNTNBNNBNNNNHNNBNNNNNTBNTTNNTNNNNNTTNBHBNTHHNBHTBBNNBNNNNNBNHTNNBNNNTNBTNHNNBHTHNNTNNNHBNNBNN
NNNTNBNNNNTNNBNNHBHTNNNBNHTTTTBHHNTNTNNNTNNHTNNNTBHHNTHNNTHHNBBNNHHNNTBNNNHNNHNNNNNHHTTNTNNTNBNNNNTH
NHHHHNHNNNNNBHHNNNNNTTHTNNNNTNTNTNTHNNNTTHHTNTNHNTNNNTHHNNHTNNNHTTHNNBNTHBNNTNNTBNNNTNNTNNHHTTNTNTNH
HNNHTHNBNNNHNNBHNTNNHHHBHTBNNHTTHNNHNTNTNNNBBHHNTHNTTNNNTNHNNHTNBHNNTNNHNNNHNTTTNTNNNNNNNNTHNHBNNTNB
NNBBHHBHBNNTNBNTNNNNNNNNNTNHNTNNBNNHHNBHNBNNBBHTNHNTBHNNNTNHNNNNNHNBNHHHNNNNHHNNHHNBNTNBHHNHNNNNHTHT
BNNNNNTHBTTNNNNTTTHNHTNHNBNNNHNHNNNTHTNHNHNTNNNNNNTTHTNTNTNNNNNTNHBNHNNTNNHTNTHNNNNNHTTNNNHNBHTTTTNN
HNNHNNTNNTNTHTNNNTHTNNTNNNHBHNTHNNNBNBHNBTNNNTBBNTNHTTTTBNHNTTNBNNNBNNHHNBBNNTNTNNTBNHHTNTNNTBNTNTNN
NTNHTNHHNTHTHNHNBTBNNNTHNBNHNTHNNHHHNNTBNHNTNNBNNTNNHBHTHHNTNTTTHNBNNNBTNNBHNBNNHNTNTNNHHNTTNHNNHNBN
BTNHTNNNNNNNNTNNNBNNNNHNTNHNBTTHNBTNNTNHNHTNBNTNTHTTHHNNTHNNNHTNTHNNNHNHHNNNNHHHNNHTTTNNHNNHHBTHNBNT
HTNTHBHNNNNHTTNHNNTHTTHTTBNHHTNNNTNNNNNNTNHNNTNNHNTTTNTNHNNHTNNNNHNNTNNHBNNHHHNHHTNHNNNNNNTNBTNBNNHB
NNNBNTNTNNNTNNHTHNTNNNBTNTNBTNHTNNNNHTHTNHNNNNNHBNTNBTNNNNHNNNNHNNTTNHNTBHHNTHBNTNNBNHHBNHNNNNHNTNNH
NBTHHNHNHHNNNHNHNNNHNTNNHHNHHNHHNHNTTHBNNNNNTNNTNNTNHNNNNNNNHNHNNHNNNBNHNNNNBTNNNHBBNTNNNNNBTTBNTHTN
NNNBNNNTNHNNNNNNNTNTNBTHHHNBNHNNHHNNNNNNNHNNNNNNNNTHNTHBBNBHNNNTHNHNNNTNNNNBBNTNHBHNNNNNBTNNNHNNNTNT
HNNHTNHHHNHNNHNNTNNTNBNHHTTBBTTNTNNHTTNNTHNHHTNNNNNTHNNNNTBBNNTBNHBNNNNNNNNTNNNHNHTNHTTNNTTNNNNHNTNH
NTBHNNNNBNNNNHNNHTHNNTNTTNHNTNNTTNHHNTHNNHNNTHHBNHHNNNHHBHBNNNNNNHNNBNNNNNNNNNNNBHHBHNTNBNTHNNNTNNHN
NTNNNNNBHNNNNHHHBNNTNHHNNTTNNNBBTNTTNNNTNHNNNBNTHNNNNTNNTTNHHHHHTHBTBHBNHHNHNTBBNNHTNTNNHTHNTNTNBTTN
HNNNNNBNNBHNHHNNBHNNTTNNNTBNNHTNNHNHNNHNBNTNTNNHNHNTHNNNNNNTHNNNHTNNNNNNNNHHHHTTTNBNNNTNBNNBNHNNNTNN
NNNBNTNBTNNNNHNNNTHTNHTBHTTBHNNBNNNTNNNBNHNNNBTHNNHNHHNNTNBNHNNNHHNNBNNNNTNHNNTNTHNNNNNHBTNBNNNNBTNN
NHHTHNBNHHTNNBNHTHHNNNNNTNBHNBNNTNHTTBNNHNBNNNBNNBNNTTTNHHHNTTNNNTNNNNNTNNTNNHTBHBNHNTNNNTNBNNNNNNNN
NTNNNTNNTNBBNNNTHHNNNNTTBBTNNNHNHTNNHNTNNHNNHNBBHHBNNNNBNHHBTHNHHTTBNNHTTTTHNNNBNTNHNNTNNHTNHHNTNNHN
NNNNNBTTNBNBNNNBBNHHNNNTNHNHBNTHNBNNBHTNHNNNTNNNHTNHHNNNNNNHNHHTNNTNHNHNHTHNHNTBNBNHHNNBTNNTHNNNHHNH
NNNHNBNNNNNNNNNNNNHTNNNBNBHHHNNBBHHTTTNTTTTHNTNNNTHHNNNHNNHBNNNNTTHNNHNHBNNNBNBBBNBTTTNNNNNNHNNTNHTT
NBHBNBHNTNNTNNNHNTTHNNNHHBBTNNBNHNNNNTHHNTBNBNTNTBNHNNNNBNTHNHHNNHHTHHTBHHHNNNHBHBTNTTNNNNTTHTNNNHHH
HNNHNNTHBTNHNNNHNTNNTNHNNHHHTHTHNTHNNNHNHNNBTBNNTTHNTBNNHTNNHNNNHNTBTTNNHNHNNNNNNBHNNTNNNNNNNHHTTTTB
NHHHHNHNTTTNNNNTNNNHBNNNHHNNBTNNBHHNNTNNNNHTTNNBNNHHNBBBBNTBNBHNNTNTBHTBHNNTNHNHBTNNHTNHTNNHNBTTNTNB
NBNNNHNNNBNNBNBTNHHHHTTNHNNHHNNHNNNNBHHTNNTNHNHNNTNNBNTNNNNTNBNHHNNHNBHHNNBNTHNHTNNHTTHBBNBNTBHTNNBN
TNBHNNNHTTHNHNNTNNNHTTNNBNTHTNNNHNNNNTNNBNHHHTNTBNHHTNHHNNTHNHNNNBNNHNNNNNTNNNBTNNTBNTHBTBHNNHNHBTBN
NNTTTTHHNHNNNNHNHNNNTNTNNTTTTBTTNBTHBHTTBHNBTHHTBNNNNHTTNTHNNNNHNNNNNHTBNNHNNTNNNHTTTTNBNTHNTHNHNNHH
BHNNNTNNHBNBNNNBNNNHTNTTNBBHHNNNNNTBTNTNNNNTNNHTHTBNNNNNNBTHHNNNHNNNNNTNHNNNNHNTNTNTNNTBNNBNHBNTNHNH
NNTNHNBNNNTNBTBHNNNNNHHBTNNBBNHTNNBHTNNNNHTNNHHNHTNTNNNNNNNNHBNHTNNNBBNNTNBHTNTTNBTTHBNNNNTBNNNBNBTH
TTNNNNBNNNTHTBTNNNTNBNTHHTBHHNNTBTNTTNTBNNNNTNTTNHTNNTNHNNNNNNNHTTTTNHBNNNTHNNNHNTNNNNTHNHNNHNHNNNBT
NNTNBTNBNNHNNBNNHNHHNBNHNNBBNHNBTNBBNHNHHNNNTNHHNNTHNNNNTNNNNNNNHHHBNBNHBNBTTNHBNTNTTHNTNNNTNNNNTHNN
HHTHHBTNNNBTHTBHNNNTTNBNTTHNNHHTTHBNNNTBNNNNNNNTTHNHBHNNHHHHTNNNNTHHNNNNNHBTTNNNNTNHBNNNBNNHHTBNNHHB
NBNNBNHNHNBNNNNHNNNTTNNNTTNHNNHNHBNNNNNTTTBHNNHHNNTTNTHNNHTNBHNBHHTBNBTNTHBNHTHHTBNHNHNNHHBHNBNBNNNB
THHNNNNNTHBNHNNNNBHNNHBTTTNNHTTHNNNTTHBBHBNTBNHNTBNTHHNTNNNHNHNNBTTTBTNTTNNNNHHTHHNHTNTTBBTHNTNNTHHN
NTTBNHBNNHBNHNNHNNHTTHHNNTTNNNNNNHNNTHTTBNHHBNNHNTNHHTNNNNTNHBBTNHNNBNTHBHNNNNNTTTNNNNNNBNHNTNTHNTNH
NNNBHHTNTBBNBBTNNNTNNNNHNNNNNTHBBHTNTBNNHNHNHNTHTNTBNNTNNNTNNTNNHTNNNNTHNBBTNTTNTTNTTNNHNHNNTHTNTTNH
NNTTTNNHTNTHHNTTNNNNHBHBHNNNNNHNTNNHHBTNHNNHNNTHHHTBNNNTHNTNNNNBNTNNNBNTNTNTBTHNHNNNNNTNNNTNTNBNNNNN
