HNHTNTHTNNNTHHHNNNTNNNTNNTHHNHBBTHTTTNTBNHNHHHHHNNHBHHHHNTTTHHNNTNNTBTTNNHBNNNHNHHNTTTHNTHHNHNBHNHNH
HNNBTHHNTTNNBNNHNNNBHTHNNNTTHTBHHTTNNTTHTNNHNNNNHBBNNNHNTNHNHNNBNNTNTHHBNNNTTTNNTHNTNHNBHHBHNNHBTTNN
NNTNNBNHNNHTNNNNNTNNTHHNHNNNHNTTHTNHNBNNHBNNNNTNNNTTNHNTTHHHNBNNTTBTNNNNTNHHHBHBHHNNNHTTNNNNHBNNNBTN
BTNNNNTNNBBNNHHTNNNNBTBHNHBBHHBNHNNHHNNNHBNHHBNBBNNNHTHNNTHHHTTNNNNHHNTNNBTNHHNNTNNNNTBNNNHNNTNBNNNB
HNHNNHNBTBHNTNHNHTBHTNHNNNBHNHHNHTNHNNHNNNHNNNBNTTBHNNHTHNNTTNNTNTHTHTHHTTNNTHNHNNBHHBBNNNTHTNBHNNNH
NHNNNBNNNBNNTHHTNHHNNTBTTNTNTHNNNNTNBTTNTNBNNNNNTNHHNTNTTBHTNBTHTHNNNHHNNTNHNNNHNNNHBTTNNNHTHNHHNTNN
NHNTNTNTNTTTBTNNNHNNHNNNBHNNNNNNNNBHNNNNNNHTTNNHNHBHNNHNNNBBHNNNHNTBNNTHTHBTNTHHNNBTNNNTHTHNNHHBTTTN
TNTNBBNBNTBNNHHNNNBHNNNTNNBTNHNNNTTHNTTTHTTNTNNNNTBNBBNNTTTHTHTNNNHNHNNHNHBHNNBBBNHBBBNHNNHBNTNTNNTT
HHNBNTHTNNHHNBHBNBNHTNBHTTNNNHHHTHNHTNNBNNNNTNNTBNTHNNNNNBNNTNNNTNNNNHNTBNTNNNNNHHNNHNHNHHNHNNNNNHBB
HTNTTTTNNNHNHNNNBBTNNTNNNHNBTNNNHNNBNTBTNNHHTNBNNHNNBNTNNNNNTNNNNTNBTTNHNHNTBHHNTNHNNNNNNNNNBHTTHNNN
TNNNHNHNNNHBNNTHTNNNNBTHNNNHNNNBNNTBTNNHNTHNTTBBNTNNNTHTNNNBNTTBHNNNNHNHNBHHHHHBHNHNNBTTHTHTBBTTHTTT
HTHNNNBNHTBNNBHBTHNNNHTNHNTHBNNHHHTTHNHNNNHNNTHHHNNHNNBHNHNTNNNTNHHHTHNTNTNBHNHNNNNNTNTHTHTHNBHNNHHT
HNNBNNNHTNHHHNTNNBNNHNHHHHBNNNNBTNHTNNHNTTTTNTBTBTNHTTTHNBTTNTNNTNTTTNHNNBBHNHNTHTBTHTNNTNTBNHTHNNNT
NNNNHBTTNTNBHTNNNNHNNHNNNNTNNHBNNTNHNHNTHNTHTNNNNHNTTNHHNNNTTNNHTTNNNTNBBNNBNNNBHNNHNNBNNBNNBNHTNNBN
NHHHHTNHNNHHTNTBTNHNNNNHNNTNTNNBNHTTHNNNTNBNNHHNNBNNNNHNHNHHNNHBNNTNTNTHTNHNTHNNNNTTNNNNNNNTNHNBBTBN
THTNNHNTHNNHBBHTNNHNNNNTBHTNNNBBTNHNHNNNNTNNNBTBNHTTNHNTNTBNNNNBHNTHBNNHTNNTNNNNNNTNNHHHHNBNTTBHNNHN
NTNHNHNNBTHHNHHHTHHNTTHNTTBNNNNNNBTTNNHNNHNBNBNBTNTNTNNNHNTNNHHBHBNHNNBNHHNNTHHNTHTHBHHNTNNNHNNTBHNN
NNTNNTNTHNHNNNTNTTNNBHNTNBNNHHHNNHHNBHBTBHHHNNHNNNHNNBHNNBNNNTNHNHNNNNNBNNNNNHNNTHBHNHTBNTBTNHNNNBTH
TNBNNNNTTNTTNNBHNHBNHTTNNTNHTNHHBNNBTTNBBNHNNBNHNNNNNHNNNNHHHTTBHNBNBNNHBNNNNNNHNNNBNNHNNNNNTNNNBNNH
TNTTNTNTTNNNNNNNNNBNNNNNBTNTNNHNHNNTTBTHHHTNHNNHNBTNNNBNHHTHTNTNNHNNNTNNNNBNNHNTHHHHTTNNTBHNNNNNNNNN
NHTNNTNNTNBTNHNHHBTNNHTNNHNNHNNNHNBBNBTNNTHHTTNTNNNNNTNNTNBTBNHHNHHTTHNNNTHHNHTBHNNHNNBHTHTNNNTHHHNT
NNNTNTNHHNTNBHNHNHNTNNHNHNHNHNTNTNHNNHNNHNBNHNNBNHNHNBBNBNTNTTNTNBNNNNNTBNHHNNTBTNNTTNNTNBHNHTTTNNNH
TTNNTNNHNBNNTNBHNTHHHHTBTNNNBNHTBNBNNNNTTNHNNNTHBNNHBNTNNHNNTNTNNNHNTHNNTTNBBNTNNTNNNNTNTNHNHNTNNHHN
TNHNNNHHBNNBTTNBHNTHTNHNNNNHNNTBNNTNBHHNBTTNTTNHTNNNTHHHHNBTNHNTHBHTNTNTTTNTTBHHNNNNNNHNHNNBNHBNHTTT
NNNNBTTNTHTHNTNNHNTNTNBBNNNTTNHNTNHHNNNNTTNNNNNHNTNHNHNNBHNNTNNNNNNNHNNNNNTTNNNNBTTTNHNTNHTTNHTNHNBN
BNNNNNNNNNBTNHNHHHTHNNNNNTHBHBTNTNNNNBNHNTBNNNNBNNHNBNNNHTNHNNBTNTNNNNNNNNNNHNNNNNNNNNNNTHNBTHTHNNTH
NHHHHBNTNNNTNTHNNNHNNHTHNNNBNBNHBNTTNNNNTBHNNHTHNNBNHHNNHHNNHHHBTTHNNHTNNHTBNTNTNNTHNNTHBBHTHTNNHBHN
HTTNNNNTHTBTBNNHNNNBTHHHBBNTBNNBNHNHNBHHNTNNTTNNBNHNNNHTNNBNHHNHHNNNNTNHNNTHNBBTNNNNNHNNTHNNHHNNHBNT
NTNTNHHTNNBHHBHHNNNHNTHHBTTNNTNNNTTNNNHHBNTNNNNTTNTTTNNBTHBNNHTBBNHNNNNBNHTHHTTBHNNNTNNBHTHNNHHNNHBN
TBBTTNNTNBNBTBHNHNHNNHTTTNNHHBNBHNTHHHTTNNNTNNNNTHTTBTNNBBBNNNNNNNTNNHBTTHNTHNNNHTNNNTNNHNBNHBTNHTNH
NHTNHNHNHNNNTHNBHHNTBTHNNNBHNTNBNBNTNNTTBNNNNNNTNTNNNNNTTNNNNNNHBHNTNTNHHHNHNNNNBNBNNTHHBHNNBTNNNHNN
TBNNNTNTTNNHBTTNHNNTHNNTNNNNNNTTTNNBTNBNNNNHNBHNNNNNNNHHNTNBNBBTNBHTNHTNHNHHNTNNHNHNTBNTNNTNNNNNNNNN
NHHNTTBNTTNNNTBTHNNNNNBNTTTNTHHHHNHNTBBNNNHNNNTNTNHTHNNTNTHNNNBHBHNTNHNHNBNNTHNBNTHTTHNNHHNNBTBHTBNT
HHHHNNTNNNNNTNNNHNTHBNNHNHTNNTNNTTBNBHHNTBTTNNTHHNNHHHNTNHTNTNNHNTBNHNTBNHTHNNTHHBNBHTNNNBNHHNBTHTNN
HHNHHNHNHNHBNHNNTNTNNTNNHTBTNTHNBHBNTTNNTTNNNHNBHNTHNTHNHNNNTTNNHNHNBBBHTHBNNNHBNHBNTNHBTTHNHNNHNHTT
HNNNBBTNBNNNHNNNHTHNHNNHNNNNHHHTTNNTHNTHNNNBNNTNHHTHNNNTHNNNHHHNNHHTTNNTNNNTTNNTNNNNNTNNTTHNTNHHNNNH
HBNNNNTNTNNHTTNTNHHNNBBNHNTNNTNNNHNHNNBNHHNBHNHHNHNNNHHNBNNTTTBNHNNNTHNTNHTNNNNNNHTBTNNNNBNNNNNNHHTH
TNNTNTHNHNNNNBHNHTTNNNNTBNNNTBHTNNTTNNNTNNNNHBHTNNNHTNBNNNNNTNHTTNNNBNTTNHTTTNHNTHNNNHHNHHNTNHBNNNBT
THNNNHTNTTHNBNTHNHHNHTBTNTNHHTNHTHHNNNNNHNBBHNHNHNHBHBBNHBTNNNTNTHNHBNTNHHTBTNTNNNNNNNHNNHBNNNNNNNNN
NHHHHHTNNNNTNBNTNNNHNHBNHNBNNBNNBHNBNHHBHTTHNBHHNNTNNTNNHNNNTHNNHNBNNBNHHHBTNTNHNBBHNNHNTTNBHBTHNNBN
NTBHNHNHTNNNHNNHTHNBTTNNNNHTTBHHHTTNNBNHTTNBNNBNTHBNNHNBTTTTNTTTNNNNHTTNBBTNNNNBTTHTNHNBNTNHNNNHHNTT
TNNHTBBTNNNNNBNNNNNNNTBHNNNNNHNNNBNNHNNNNHNNNTNTTNNBTNTHHNTBHNNNHNTBNNTNNNNBHBHHHNNNBNNBTTHNTNHNTTNH
NNBTHTNNHNNNHHNNTBNNHNHHTNNBHNHNNNBTNNNNNNHHHBBNBNNTTNTNTNNNNNNNNHNNBNNTBBNBBNTTNHNNHHHNNNNNTTNHNBBT
NHTNTTNNNNTTNNNHNTNBNNNTNHNNBNNBHNBNTNTTNNNNTNTNNNNNTBNNNNNNNHBHHHTNHNTHHNTHNNNTHTBNHHNBNTNHTNNNBNTN
BBNBBTHNHTNNNBTTBBHHNHNHTTBNNTNNHTNTTNNTNNNNNNNNBTTNHBNNBHBNNNNNNNBHNNTNHTNHTNNNHTHNNTNBHHTNNNHNNHNN
HBNHTHHNTTNTTNTHTNHNTTTTTBNHNNNNTTTTNNNNHNNTTTNTTNNTNTHTHNHNBTTTNNNHNNNNBTNNNNNHTNBNNNNTHNNNNNHNHNBN
THNNNBNBNNHNTBNTNNHNHNNHTNNTTNTHHHHTTNHNNNHTTNTNHNBNHBHHHNNNBNNNNTNBNBNNTHTNHHNTNNNTNHNBNHNNNNNTHBNN
HHHBNNNTHNHNTHHNNNTNTNNNBBBNNNHNNBNNBHHNNHBHBNHNBTNNHTHTTHNBHBNTHBNBNNTNHTNNHNNHBHHTNHHNNNHHTTNHNNBH
HBTHNTNNNBNHNTHTNTNNTHHNBNNNTNHNNNNNNBTTHTHNTBHTTNHNNNNNHNNNNHNNBTNHNBNNNTNTHNNNTTHNNNHNBTTTNHNBNTHH
TNHNNNTHTNNNHHNNHHNBNNNNNNNHNNNTHTNTNBNTNNNNNBTTNNBBNTNTTBTHBTHNNNNTHNNNNNTHHBNHTTNNNNNTNNNNNNBNTHHH
BNBNBHNHNTNTNHBNTHNBHNHNBTBHNHHBTNTNHNHHTNHNNHNNHNNNTNHNNHTHNBNBNHHHNTHNNNNNNNBBHNBNBTNHNNBNNHHTTTNN
NBHHBNNNNHHTHNBHTNBTHBNTNHNTBBBBTNTNNNTHNNTNTTTNTNHNNNBNTHTNNTHHBNHNTNTBNNHNHHNTNHNHHNHNNHNNTNTNNNNH
TBTNNNHNNNHBNNNTTTHTHTNTNNTNHHNTBHNNHNTBHNNHNBTNTNHTTBNNTTTNNTNBNTHNTNNNNNHNHBBNNTTTTTHTNNNNBBNTNTNN
TNTNBNNBTHBTNTNHTHHHNHBNNNHBHNNNTNHNNTTNHBNNTNNNNNNNNHNNNNTHTNHNBNHNHNHNTHNTTNBNNHTTNNNNNNNTTBBNBNNN
NHTBNHHHTTTTNBHTHNNNBTBTHTNNBNTHNNTHNNNTTNBTTBNNNBBNHTNHNHNHNNNNHHNNBNTNNNNHTTHTTNBNNNHNNHBBNNHTNNNB
TNTBTTNNNNNNTNTTNNNNNNBHNHHTNNNHNHTBTHBBNTNHNTHBNHBHHTNHNTTHTHNBNHNBNNTNHHTHNNTNBNTHNNNTTHHHHNNNTBNN
NHBNHNHHNNNHHNNHHTBTNNHNHNTHBBNTNTTHTBTTHHNTNBHBNBHHHNTTBNNNBBBNTTTBTNNNHHNBHNNNTNNTNNTBHNNNHHHTNNNN
NNBHNHNNTBHNNNNHTTNNNNNNHTNNTNNNHHTNHHNTNBBNHNNTBTNTNHHTHNTNHNBNHTNNNNNTNNHHHNNNNNNNNNTNTNNNHNHNHNHB
THNNNHHNNNNHTNNTHTNNBNNNNNNBTHNTHBTTNTNNNNBBHHNNNHTNNBNHNTNNHNNTTTHHTNBNTTNNHHNTNHNHNNTNHNTNHHTTBHNN
TNNNTNBNNNNBNNTTNNBBNTTTBHNHBTHNTTBNTNNTNNHHNTTNNNTHTHHNNBNBTNTNNNHHNHNNTNTHHNTTNTBNTBNBNTHTNNBHNNHH
NNHHHBNNTNNNTHBTNBHNTHHHTHNNNNBTNTNHBNNNTHNNHTTNTNTHBTHNHHHNHNNNTBNBBHBBHNTNTNHHNNTNNNBNHBHHTNHTNNNN
NHNTTHNTTHNNNNNTNNNNBNNNNNHNNHTNNNBTHNNHBTNTTNHNTNNHNNNNHTNHBHBHNNBHNNNBNNNHHTNHNHNHNNNNNTNNNNTNHHNH
NBHNTTNNNNNNNNBNTHTNHHBTNNHBTNBNNNTNNBTNNNHNNNNNBNNNHNNNNTNNTHTNNNNNBTBHNHBTHNNNNHNHNHNHTHNNNNTHNTHH
NNNNTHHNHTHHHTTHHNTHTNNNNBNNNNNHNTNTHHTTNNNHBNTHNBNNNNNHTNNTHHTNHBNNNBHNNBNHTTNHBNNTBNBNTBTNHTNHNNNN
NNNHNNTTNBNNNNTNHBNNBBHHNTTNNNNHNNHTNNNBNNTNNTHNHNTNHHTNNNNNTNNHNTHNHTHNNNTHBNNBHTTNHHHNBNNNTNHBBBNT
THNHNTHTTHNBBNNBNNBHNNNNTNNBNTNNHNNNNHTNNNNHBNNNHNHTHNNNHBHTNBNNBNNHNBNNNBTNHNNTHNNNTBHHNNNHNNBTHNBN
TNNBBTNNNHHNHNHHTNHBHTBNTHNHNNNNBNHHNHNNNNTBHBNNTNNNTNBTNHNNTNHHNBNTTBNNHTNHNNHNHTHBNNBNNTTTNNNTHNNB
THNTBNHBBTNHBHNNHNNBNHNTHHNNNNNNNBNNBBHNNTTTNNNTNHNNNNTNTNNTBTHHHNNNHTNNBNNNHNHTBNNBTNHNHNNTHNTBNNNN
NTTTNNHTNTTNBNNHNHTNHHNNBNNNNBHHNNNTTBNNTHHBNNHTHNNNNNNNHNTNNTTNNNNTTTBTNBNHNBNNNNBNBBHNHNNNNNHTTNTN
HNNHNHNHNTBHTTNNNNNTTNNNNNBNNTBNNHTNNNTTTNTTTNNTHBNTNNHHNHNNHTNNNNNNBNHBTHHTNNNHNTNNHNNTNTNNNHNNNBNB
HNNNNNHNHNNNTNTNNNNNNNHNNHNBNHNNHTNNNHNNTNNNNTNNNNHTTTNNBNNNNNNHNNHHHHNNNNTHTBHTHNNNHNNNNHNNNTHNNTNT
NHNNNHBHTHHHBNHNNBNTNNTNNNNHNBNTTNTTNBTHNBHNTBNNHHTTNNNHNNBTNTNNHBNTNNHHNNNHTTNNTHHNHTBBNNHBTHHNBNNN
HBTNBHNBNNHNNNHNNNNNNTNTHHHNNNTNNHNBNNTNNNNHNTNNHTBNTBNTHTNHTHNHTBTNHNNNNBHNNTNNNHNNHNNNBNBNNTNTTHNT
NTNNTBTTNNNNNNNNNHNTNNBNNNNTTHNNBNNNNTHNNNHNNHTNTNTNHHNHBNNNTBNNNNNNTHNHHTNNHBTHHNBBTHNNNHNHTNHHTNTN
HBNNHNHBNNNHBNNNHTHTNHNNBNTHBNNNBHNTNTBNTHHTNNTNBTTNNNNNBNBNNHTNTNHHNTBNNNNHNNNTTNTHNTNNTNNNTBNBTTNN
THNNTTTHBBNNHTNNHHHTHNNTHHHTNNNNNNHNNNTNTHNTTNNNHHNNTNTHHNNNNNTBHNNHTNTHTNNNNNNNBTTHNNNNNNHNNNHTNNTH
TTTHTNHNHNNNNTTNBNTHNNNNNBNNNNNTBNNHTBNHNTNNTTNNNTHNHTTTBNHNBNNNNBHTTHBNNNNBNHHNNBHNNHTNNBTHHNBNNNNN
TNNTNNNTNNHHNTTTTNTNHNHHBNNBHNHTNNHHNNHNHNNNTNNNNNTTNHNNNNTTNNHNTNNTNBTBHHBNNHNNBHHNNNHNNTHTNNTTBNNN
NTHNNBNNNBNNNNNHNHBNTTHNNTNTTNTNTNNNNBBBNNNNNBTNNNTNNHTNTNBHHBBNNNNNNTHHTNNNNNHTNNNHTTNHNTTBNHNTHNNN
TTNNTHNNNTNHTTTBHNNNHTHHTNHBHNTNNHNNNTHHNTHHNHTBNHNTNNNNNNTNNBHNBNTNNNTNTHNHNNTBHNNHNTNNNNTHNTNTNTNH
TNNNNNBTNNTNTTNNBNHNNHTNNNNHNNNHNNHNNNNNNBHNHNHBNNBHBNNNNNBTNBNNNNNTHNTNHNHHNHHBTBBBHNBBNNHBHNBNNBNT
TNNNTTTHNNNTHBNTNHNNNNHTNBHTBHBNTNNNTHNNNNNNTNBTTNHHNNTTNHTNTBNHBNTNHHHNNNNNNBTNHNBNNTNNNTNNNTNHNHNH
NNTNHTTTHTTNHTTTBHNHNNBBHBBNNBNTNHNNNNHTNBBNTNNNHNHNTNNNNHBBHNHTTNNHTNNTTHTNBTNNTNNTNBNNHNHTHNBNTNBB
NNTNTHHNNTTTBHTTBNNBNBNNNNTBBBBNTHHHTTBHTNTBNNNNBNNNBTNNHNNNTNNHHNNTTHNHHBNTTTNNNHNNNNTNNHNHNTNBNHNN
HNHHTTNNNNNTNTNNHHTHHNTNHNNHNNNNNTNNNBTTNNBNNNNHHNTNTTNNNNHHHTNNTNNNHHNHNBHTNNNNHNNNBHNNNNTNNHHNTNNN
TNNHNHNNNNTTNNTNNNNTNNTBNNNNHTTNTNHNNBHHHTTNNBNNHTHNNBNNNNHHHTNTNHHTNBNNNTNNNNTNNNHBNNTNTNNTHHNNNNNT
HBHHBNNNNNHTHTNNNBHBNTNTNNNNNHHBTNHNNHNTTBTNNTHTNTNNNBNHTTNNBTNNTBNTHTNTTHNNTBHNTHNHNHNBNNNHNNHBNNTN
NTTNNNTTHNNTNTNNNNNTHBNNBHNTNTNHBHBNNBNHNNNNBNNNBNBTBNNTHBBNBBNTNTHHBNNNNTNBNNTHBNNNTTNTHNTHNNNBNTNB
NNTNNNNNNBBHNNNHTTNNNHNNBHNHNNNBHBNBNBNNNNTTBHTNBTNNNBTNTNNNNNTTNNTNTNNNNNNTNTNBBBTNBNBBNHNNNHNTTHHN
NHTNNNNNTNTNNBTHHNNHTNHNNTTNHNHNTBBBTHNTNNHHHNNNTTHNBTNHNTNHNNTNNNNTNNNHNNNHNHHNNHBHBNBHNTNHNTNNBTNT
HTTNNNTHNNNNBNNTHTHTNNHNHNNHNHNHNNHNNBNHHNNBHNNBNNNNNNHHBTNNTNBBNNNNHNHNNNTNHNBNTNNTTHNTNNNHNNBNNBNT
NHNHTHHHHNNTNNNNNNHNNNNHNHTHNNTHNTNNNNNNBNTNNHNTNNNNNNTTNBHTTNNNHNNHNHHTNTNTTNNNNNNTTTNNNBNTNBHBHHHT
NNBNNHHBHNNNNNTNNNHNNNNHTHBNHNNTNHNTNNNNTNTTNHNTTNNNHNHNHTNNHNNTHNNTTNTNNNBHNTNHNNBTTNBTTTNHNNNHHHNN
NHNNBTHHNHHNNNTTHHTNNNNNTTTBTTHHHHNNNNBNHHHTBNHNHHTNHNTTNTNNBNHNHNNNHNTNTNNNNBTNTBNHNNNHHHHTNNTNBBNB
HNTTNNNNNBBNNNTNNTNNNBHBTTNNTHTNNHHTTBTNNNBNTTNTTNTTNNHTHTBNTNNTBBNHNNTNTNNHNHBTBNNNBHNHTTNNNHBTBNNN
HHHHNNNNHTHNHTNHHNBTNNNNNNNHNHTNHNNBTHHNBNTBBNBBNHNTBBHNNNHTHNNNTNNNNNNTBTNNHHTNBNTNBNBBTNNHBTTTNTNH
NNNBNNNNNNBNTNNNNHNHNNTHNNTTHTNTTNNNNTNNHBTNTBHHHTNNTNHNNNBTNNNHNNNHNHBHNNNHBNNNHNTHTTBNHHHNHNTNNNTN
HHNNNTHNNTNHHHNTTNTNHNNNNNNHTNTNHNBTTTBHHNNTNNNHHBNTNHHNTHTHNTNNNBNTNBTNBNNNNNTNTNNHNBNTTTNTNHHHNHTN
NTBBHNHTHHNHHNNHHNHBTNNTHHNNHBNNNNBNHHBNHBBNNNHTNHTNNNTNNNHTHNNNNBNTTBNNTTBBBNBNHNNNTNBHNNTBNHHHNTNN
NBNTBNNHHBHNNHTNNNBTHTTNTTNBHHNTNBNTTHNTNNNNTTBNNNNNHNHBHNNNNNHNNTNNTNHTNNNNNTTBHHNHNHTNTTNTHBNNNTHN
