HBNNTNHNNTHNBBTNHHBTBNNHNNHNHNTBHNNNNHNNBBNTNNNNHTNTNBBTNNNNNHNHTNHBNHNNNNNTBTNTNTNNNNHNNNHHNNNTNHTH
HTHNNHTHNHTTNTBBNHNTHNHNNBNNNNHNHTHNHNHHNNBNTNNHHTHNTTBNHNNNHHNHHNNNTNNNBNNTHNHTNNNHNNHNTNNNNNHNBHHH
NBBHNNBTNNBNNNBNNNTHHNBHNNNTTBBHBHNNNTNNNNNNBTNNHNNHHBNNTTNHTHTNHNNNTNHNNNNNNNHNNTNHTNNNNHNNNHNHHTTN
TBBNTNHTTTBHTBTBNTBNTTNTNBNNNNHNNBNNBNHNHNNHNNHTHBNHTHBTNTNBNTTHHNNHBHTHNNHBTNNHBNHNHNTTTBNNNNTNNNNN
NNHTBNNBNNTTHBHNTNHNNNTNTHNNNBBNTTNNBNTHNNBTBNTHTBNNTHHHNTBTTNNTHNNTTBTBNHTNNTNHNHBNNHNTNNNNBNBNHNHN
TNTNNNNTNHHHHNNHNBNTNTHNNBHBNNTNNNNNTHTNNHNTNHHHTTNNTNTHBBTNNBNBTBNNHHNNBNTNNHBHBNNNNNHNNNBNTNNHHTHB
NTBHHHNTNNHBHTNBHHHHBHNHNHNNNNHHNTNNTNBTNNNNNHNNTHBNNNBNTNNNTNBNHNNNNBHNNTBNNNBBNNTHNTHNHHNHTNNNNNNB
HTNNNNNNHTTHNNHNBNHNNNTBNNNNNNNNNTNTBNBNNNTNBNTTBHNNNNNNNNTTHTNNNNHTTNTNTHTNHHNNNTNNNNNBNNBNNNBTNHTT
NNTNBNTNNHNBNBNNHTHNTHNTNNHNNNNHNNBNNNNHBHNNBHNTNTNTHNTTBHNNHHNTBNNNNNNNTNBNBNNNHNNTBNNNNNNNTNNNTHHB
NNTNNNTNNNHBHNHHTNNBNNNTBHNNNNNTNNNTNNTBNHHBTBNNHBNNNTTNBNNNHNNNTHNNNTNTNNNTHHNNNNNNTNTHTTNTHTTHTNNB
NTBNNHTNBHTNHHHNBHHBHTNTNTNBNNNHHNNTTNNHTBNTHBTNNTNNBNBNNHNHTHNNNNNNTHTTBHNBNNBHTNTHNNHNNHNNBNTNNNBN
NBNTNNHBTNNHNHTHHBBHTHTNNBNHNHHNNTNHNNNNNNNNTBTBTNNHNHTNHBHNNTTTBNNTNNTNTHNNNHTNTBNNNHTNNNBNTTHTNNTN
HNBHHNBTNTTBNNNBNNTNTNHTTHNNNNNBNNNTHNHBHNNTNNHNHHTNBNNNTHTNHHTNHHNNNBBHNHHBTBTHBNNTNNNNNHTNNHHNNNBN
TBBHNNHNNHNTNTHTTHNNNNNNBBNNTTTBNNTNNTNNTNNHTNHNBNNHTTHNHHNHNHTNTNHNNNHNNNNNNTNHTNHTNTBHHNTTHNTNBNNB
NHNNNTHNBNTNNNNNBNNNTTHNBHNHHNNTHNNBNNHNNNTBTHNBHHNHHTNNNHTNNNNHBBTHNTNNNNHNBNNTHNTNNNHNNHBNTNTTBHNB
NNNTNHNNHNBTTNNTNNNBNBTNHHTHNNHNHHNNNTNNNNNHNTNTHNBTNHNHHNNNNNHNHNNNTNNNBNTNNHNNTHTHTNNTNNTNNHBTNNNB
BNHTTNTHNHTNBHNNNBTNTHTNNNNNHNTNBBBTHNNHNNNNNTTHNTNNHNNNTNBHHNNNHTHNNHNHBNNBHNNBNNNHNNBNNHNTNHNNHNNN
HHHTBHNHTNNBNTTNTNNNTNTTNHNNTTTBNNHHHHNBBNNTNNTHNTNTTHHNNBTTNHBTHHNHNHNNNNHNHBNNHNHBNHBNNNBNBTHHNTNN
NNNNTNTHBTBHNBBTNTTNNBNNTNTNNHHNBNNTNTNNNNBTNNNHNNHTNHHNNHHNHHNNTNTHNHHHHNNHNNNNNHBTTNTTBNNHHNHNBNNH
HTNHTBNNBNNHTHHNTNNNNNNNNBNHHNNBNNNHNNNNTNNNNTTBTNHHBTNTTBNHHNBTHBTNNHNHHNHBTTNHHNHNNTNNNNNNNBNHHNBN
HTNNTNTNNTNHTHNNHNNTNTHHNNTNNNNHNNNBNNHBNNHNNTNHTNBNNHNTHHHHNNNNHNNHTNTTHNNTNHTNNNNNTNNHNTNBTHNTHNBN
NBNTHHNHNNHNNNHHHNNBTNNBNNNTNHBHBNHNNNHNNTNNNHTNHHNTTNHNNNTNNNNNBNHNBTBNNNNTNTNHHNHNNNNNHHHNHTTNNHNB
NNNNBNNTHNBTHBTHTHNTNNBNTNNHNBNHTNNBBNNNNHBNHTHBNHTBNBBTTTTNTNNTNNBHTNNBNNNBTTNNNNNTTNNTNNTTHTNNHNHN
NHBHNTHNNTHBTHTNNNNNNBNNNHHTNHNBTHNBNTNTHHNHNNTTNNTTNNNBNTNHNNNNNNBNTNBNTBBBTNHNHNNNNNNTNNNHTNHNNNTH
NBBHNBHNTNTNNTNBNTNNHHHTTTNNBTTNTTNNNNNTNNNNTHNTNNHNTNNTNBBHNHNNTBNBHHBNHNNNNBTNTTNNHHTNNNNHHNNTNNNT
TTTTNNNNTNHTTBHBNBNNNHHHTHNNNHHHNHBHTNNTTHTTHNNBBBNNNTNTHNBTTNHTHTNNNNNHNNNTNTNBNHNHNNTTNTTHHNNNBNTN
BTTBNNNTHNNHNNBNNHHNTNNHNNNTHHHBNHNHTNTHNTTTTNBNHNNTBNNHHBTNNNNNBTHNNNTTTHHBNHHHTNBNHHNNBBNNNNNHHNBH
HNTHNNBBNBNNBBNHTNHNBNNBNHHBNNNTHBTNTNBNNNNNTNNHTNNBNNNTHNNTNBHNTBTTNHNNTTHHTNTBTNBHHHHNTNBHNBNHNHNH
NNNHNHNNNHNNTTTNNNNTNHHHBHNNTHNBNHNNTTNBNHNBTTNBTNBNHNHBNTTNTNTNNNHNBNNNNHHNNNNHBHNNNHTNNHBTNHTBTNBN
TTNNNNHNBHNTHBTTTHBNNBNNHHTNNHHNTHNTNHNNBNNHNBNTHNBHHHTBHTTNBNTNNTNNBHNNBBNNNBNHTHHHNNTNNNNNNBBTTNTN
HTBNNNNHBNNNNHNBHBTNNBTNNNHNNTNNBNHNTNHNHNTNBNHHNHNNNNNBNNBHTTHHNNNBNNBNTNNNNNNNHNNNNTTNHNBTNHHTHNTB
TNNBNHTBNNNTHTNNNNNHNNNNTHTHNNNBNTNTNBNNHNNNNHNNNNNTTHNHNNNHHHNTNHNTHNNNHHNNNTNNNNNTNTHTNTNNNHNNTNNN
BHNTHNHNTTNHNBHTHNHNTHNTNTHNNNBNNNNTHHTNTHBNTNNNNNNNNTNNNNHNNNNHBHNHBNTNHTNNNHTHHHNTNNTNNTTHNTNTHBNN
HHNNNNTTNNNTTHHNNBNHNTNTNNNHNTTNTNNHBNTTNHHNHHNTNHNTNTNNBNBNNNNNNNHNNNNNTBHTHBNBNBNHBBBHHTNNTNTNHHNB
HHNNTTNNHHBNNNTNNNHHNNNHHHHTNTNBTNNTHTTNNNNNNHTNHNNHHTHHNTNNHHNHNNTNNNBNTNTNTBNTTHHTHBHHNNHTNBBTNBNT
NHNNNHNHTNNTNNTNNTHTHNNNHNNNNHNTNNTBNTNTHTNNNTHNHTTNNHNTTNNTNBHTHTTNTNNTHBNTNHHNNNNHTNTNTBNTNHTNNNTH
HTNTNNHNTTBNTNNTHNHTNBBBHTNBHBNNTNBNTHBNHHTNTNBBTHTTHNHHNBNHNNTTHTBTNNHBHHNNTNHBNNNBHNBBHTBTBNNTNNNH
TNTHNNNNHBNHNNNTNTNNNTNNNTNNTHNTTHNTHNHNNNTBNNBTNBNNTTHNBBNHTTBNNNHNNNNNNNNHNTNTTBNHHNBNTNNNNNNTNBNB
NNTTBNTNNTBNNNBNNTHNBNNNNNHNNTTTNNTHNNHTNBTNBHNNHNHBHHHNNNNNHNHNNNHNNNNBNHHBHTHNNNNNNHTTHNTHNTHNHNBT
HNTTNHHNHNNTBNNTBTBHNNHHNNBBNTHNBNNNNNNTTNNNNNTNNTBHHHTNNNTHTNNNHHHHNNNNNNNNTBNTNNHNBTTNBNNTNNNNNTNB
TBTNNTNNTNTNNHTHNHNBBNNNBNTTHTBNNHNNHNTHHTNNTNHHHHNNHNNNHNTNHTNHNNNNTNTBNBNNNTNTTNNNHNHHTNTBBTNTNHNB
NBNBHNNNTBNBBNNTNHNTNNHNNNNNHTHNNNTBHNNNBTTNHNNNNNHNNNNTNNNTTHNNNNNTNHTNNNNTNHBTTNNHTNNHNNTNNNNHBHNN
TNNTTBBNNNNNTNNNNTNNHNNHHTNNNBNNNHHNHNTHNNNNHNTNNBHNNTNBNNNTBTNHNNNNBHNTNNNBHNNNTNBBNTNHBTTBTBNTBHNT
THNNNHNHNBTNTNTTNHNHNTHNNHNNNBBNTNNNHNHTHNNTNHNNBHBNNNTNNHBTNNBTNNBBHNHNTHNHNHBNHBTNHHNNNNNBHNBNHTBN
HNTNTBNNNTTHNNHNTHNNNNNNNNHHTTHHTNNNHNNHTBNNNTTNNBBBHNTNNTNNTTTNBNHTNNNTNNNBNTNNTTTNNNNTHNNHHNTNNNNT
BHBNNTHHBNHNNNNTNHNNNHNNNHBHHNNNTNNNNTNNNTNHNBHNTBTNHTNNHNHNNNNTTNNNHNNNBHNBNHNNNNNBNHTHTNNTNTHHNBNN
TTNNBNNNNNTNHTTBHNNTBTTBNNHHNTNNNNNNTHHNNHHNNTNTTHHNHHHHNHNNNNNBHNBBHNNNTBNNNNNBNNNTNBNNNTHBNHHNNNHH
NTHNHHHBTHNTNNNHHNNNNBBNNTNBNNNTNBNNNBTNTHNHNNTNNNHHTNBNHHNNBTHHNHHNNTTNNHTNTNTTNTTHNNNHNTNNNTTNTTHB
NNBNNTBNNNNTNNHBHNNNHNBNNNBBNNNNNNNHNNHHNNNHTNNNTNHNTNTNTHNNNNTHTHNNBNNNTHTTHNTBBNNHNNTNNHNBNNNTNNHN
THTTTNNNBBNNNTHNTTNTHNHHHNTHNTNNNHNTHBNTTNTHBBBNNNBNNNNNNHHNNBHBNTHHNTTBNNTNNBTNHHNNNNHNNNTTNNNNNTBH
NNNBNTNNTBNBNNNHNHBNHHNNNBTNTHHNNNNTNNBHHNNTNHTHNTNHTNTNNHNNHTHBNNHNNNNNTNNHNTNHBNNBTNNTTNNTTBHHTTNN
NHTHNTBTTNNHBHHTNNNHNNNNBHHTHNTNTNNTNNTNNHNTBNNHTNNHNNNNNHNNHNNNNBNNTTHTNNHNNNNHNNNTHBHTNHNNBNHNTTNT
TTHNTHHTNNNNHTNHHNNTNHBHNNTNNNNNTHNNTHNTNHTTHTNBTHNTBNNHNTNBNNNNBNHNHHHBBNHBHHHBTNTNNBHTNHNTBTNHNBTN
NNNTNNHTTNTBTNTNTBNNTNHBBHNHTNBNNNNTNNNNBHNTNNNTTTTNTNHNHNHNTTBNNNBTNNNHNHBNNTNHNTNHNNNNNNTNHNHNHNNN
NNNHNNNNHNNTTNHNNBBNBTBBHNHNNNNNNHHNNNNNNHNNHNHTNNNHNNHNNHTTNNBHHNHTNNBNNBNNTTBNNTTHNHHTHNBNNHBBTNTH
NTNNBNTBNNHHNHNNNNNNTBNBTHNNTHNNNHNTNHNTNHNNHNNNBTHNNNBHNTHNBNNNNNNNHNNNBNHNNBBNNHHTTTNNNHTNTBNHNNNT
NNNHNHTNTNTHNNNBNNTNHBTNNHNHTHBNHBNTHTHBHTHNHHHNNNNNNNHNNHHTNNHTBHNTHNNBTNBTHNNNNNNNNNNNNHNTBBNNHNNN
TBNNBBNTTNNNTNTNBNTNHNTBTNNNNTNHTTNHNHTNHNBNNHNNBNTNNNTNBNNTNNTNBTNNNNNNTBNHNNNBNNTHHNNNNNHNNHBTNNNN
BNTNNBBTHNTNNNNNTNBHNHTNNNTTHTNTTNNNTBNTHTNNNNTTNHTTTNHNNHHNBTTBTHTHNNNNHNNTTNNBTHNNHNNNTHNTNNHBNNBT
NTTNNHTNNBNBNNHTNNNNNNNHNBNNNNHHTNBNTNNBNNNNNNNHNTTNTTTNNTNNTBNNNNNTNBHBNHNTHNTBTHNNTNNTBNNNNNHNNBNH
NNBTNTNHNNNNNNNHBNNNBHTHHNHTBNBHNBBNTTNHNNTNHBTHTTNTHBNTBHBHHNHNBNNTNHNNHTHNNNTBNHTHHNNHHNBBBHNTTNTB
TNNNHTTTHTHTHNNNNNHTHNNNHBNTNNNHNBHNNNNNTNNBNTHNNHHNTNHNTNTNNNHNNNHNNNBHHTBNTTNNNHBNNNTNNHHTHNHHHHNT
HNBTNBHHNNBNNNHNTBNNNNNBNHBHHNTNNNTNTTNTNTNNNNNHNNNTNNHNNNBNTBHHNNNNHTNNNTNBNHHTHTTHHHNHBBTHNHBNTHNH
BNHBTHHTHNNNNHTTHTBNNTNTNNTHNHNTHNHNHNNNHNHNNNNNHNNNHBTNNNTNNBTNBNHTNNNNNNNNHTTHBNBNTNTNTTHHNHNNBTBH
NNNHBNNTNNHHTNNTNBNTBHTNHTNNTNNBBTHTHNTNNBTBHTBNHNNHBNTNNTNTTHBNTHBHTNHBNTHNTNHNNNNNHNBNNNHNNNHTNBHT
NHNNHNNNNNNBTBNTHNNNNNTNTNNNHHTTNNNHNHNHNNNHTNHHNNNNNNNNHTHNNNNTNTNNNTNTBHNHNHNTTBTNHNHHNNNBNTNTNNNH
BHHNNHNHTNBHNNHNNNNHBTHTTBNTBNTNTBNNNBNNTNHTNNTNHNTBHNHTNNHNHNBNNTTNNBNHHNHNTNNHHHNNTNHNTHHNHNHTNTHN
HNBNHBNNBBNNNTNHNTTNTBNNHHNTHNTHBTHTTNNTNTBTNNTNNBHNNTTNNNTTNNNNNNNBNHHNHNNHNNNNBHNHHNNTBNNNNTNTHNTH
NHHBTHBBNBNNNNNNNNNNTBHNNTNTNNNTNNTTHNHNNHTTNNNTHNNTNHHNTBHHNNTTNHNHNNBNNNNHBNHNNNBNNNHNNTHBNNNHTNTN
TNHNNHTNNNBNTTBNNTNNBNTNNTTNNHNNHNNNTNBTHNTTTNNNBNNHNHNNBNNHHNNNHTNHNBTTNNNBNNHNNTTTNNTHTTNHTNNHNNNN
NNHHNNHTBNNNTBBNHNNTNNTTHNNNNBHNNNTTNTNNNHTNNHNNHTTTNHTNHNTTNTHNNTTHNNBNBBTNNNHHHTHNTNNNNTBNNNHTHTHN
NNHHTNHTNNTHTHNHTBNNNTNTBNBNBTHNHNNNTTNHTHNHHNTNNHTHNHNNTNBTHTHNTNTNNTNNTNNHNHTNNTHTHNNNNHHHNBHHHNNN
HBNNNNNNNBNBNNNNNNHNNHHTHBHNNBNBTNTNBTNNNNNHTTNNNNNNNHNHTHNTHTTNHNNHNNTTNTTNNNNNNBHNNNHHNHTTNTHNNNNH
NNNTTNHHHTNNNNNBNTHNNNBTBTTBNHNHNBNTBHTNNTNNBTBNHTBTNBNHNNNNHNHNHNHBNHTTBHNNNHNNTNNNHNBNTNNNHTBTTTNN
NNNNTNNNBNNTTBHHNNNTNBHBTNBNNHNTHHNBNTNTHBHTNTNBBNNHTNNNNBNNBTHBHNNHNNNNNHNNTNTNHNBBTHNNTNNNTNNNNNTN
NTNNHNTNTNHNNNNHNHNTNNNNNNTNNTNTNNNBNHBNNTBTNNBTNBNNBTNNHNNHTTTNNBNNNNNNNNBNNNNNNTNNHBNNTNHNTBNNBBNN
HNNTTBBTNHHNNNNHTTTHBNHTNHTTNNNHNTHTBTNTTTNNNHNHHNNTBNTHBHBTHHNTBTTBNNNNNNNHHNNNNTNHNNNTNNTHHTTHBBHN
NNTBTNNHBNNNNHNHBBNNNHHTBNTNTNNNNTNNNNNTBNBNTHHHNTHBNHNNNNTTNHHNHTBNBHNHNNTNNTTHTNNNTNHNHNTBNNNNHHNT
NTTNNNTBHNBNNTTNHNTNNNHTTBNNHNNNBNNTNNBTNTHHTTHTHTNNHNBNTNNNHNNNNTTHNNNTTNNHBNTHHNNHNTTTNNNTNBHNHHTH
NHBBNTNTNBHTNNBBNBNNTNTBTNNHHTHNNNNNTTBNNHHNNHNHNNNNNNHNNNNNNTHBBHNNNTBNTHNNBNTNNTNHNHNNTNHHNTNNTNNN
TBHHNHHBBNNBNBBNNNBHHTHNNTNNNNNNNNHBNBTNNHHNNTHHNHNTTNHTNNHTTBHTNNTTNHNBTNNBNNHTNTBNTNNTHNTBBTNTHBNH
NTBHNBNNBBNNNNHNNBNTTNNBHBNHNTTNHNTNNNNNNNHNTTHHTNNNTTNTNBNNNNNTNTHNHNTHHHNNNNNNNHHNHBBNNNBTNHNNNHNN
BNTHNTTBNTHHBTTTHNBNTNHBBHNNNNNTNNNTBNTNBNHBHHHNHNNHNBHNTNNNNTNNNBNHTNTNNNNHNTNHHTNTTBTNNNBNNHTNNTTN
HNHNHHNTTNNNNNNHNBBNBHNTNNBNHHHNHBNNHNNNTNBNBNNHTNHHNTNNNHTNHNTTBNNHBNHHNNNBHHTHBBNNNNHHNNNNNTNNHNNN
HNNHHNTBNTNNTTNHNHHTHNNHHTBTBHHBTNTNNNBNTNHTNNHNTNNHBBTTTNTBTTBTNNNNNHBNTHTNNNNNTNTNTHTHHNNNNTNHTTHH
NTHNNHBBTBNNTHNNNNHNBHNNBNNNHHHBBNNNTNNTNHNTNHBNNNTNNNNNNNNNTHHNNNNNNBBBNNTNNNTBTNNBNNNNNNBNBNHTNNTN
HNNHNTHNTNHTNTNHTNBHNBNBTTHHNNHHNBNNHTHNBHNNNTNNNNHTTBNNTNNNNNTHBTNHBNHTHNHTTHNHBNNNTNBTHHNNNHNBNHNN
NTHNNHNNTTNNNTTNTHNNNTNNNBTTHTBTNNHHTNNHNHNTBNNHBNNNTBBHTBHHNNNTTNNHBTHTNNNTHTNHNHHNBTNHNNTTNNNNNNNB
NHNTNBNHNHNHTBNHNTNBHBTNNNNNNTBTNTNTTTNNNHNNHTTTHHTNBHBHNNNNBNTTNNNHTHNHTTBHNHNNTNNTNNNNHNHHNTTHNBNN
TBNHNBHNNNNNNNNNNNNNTNBTTBNNNHHHNNTNNNHTHNNNHTHTNHBBTNNNNTNNNBNNNTNBNTNNNNNNTNTNNBHNTTNTHNHNTHNNTHNH
TTNNNNNBTHNNNBNNNNTHNHTHNTNNNBNNNBBNHHTHNNNNHBBNTNHNTTNNHTNHNTTBTNHNNBBNHNNNNHNNNTBNNTTTTTNNNNTBTBNT
NHNNHHNNBNNNNNNHHNNTHBBNNTNNBNHNHTNHBNHBNHHTHNHNHHTNNNTTTBNTHNTNHTNNTTNNHBNTNTHNNNHHTNNTNNNNNNNTNNNN
NNNBBNNNNHNNNNTNNNHNNHBHTNNNNNNTHTHBNHHTNNNHBTNTNNNNNNTNNHNNNNNNNBNNTHTBHNNNNBNNTNNHNTHHHTHNNBHNTTNN
BBBNNHTNTNHNTHHHTTTHHNNNNNNNNNHTNNNTTHNHNNNNHHNHHTHNHNNNNNNNNBTNBNTNHNTTHNNNHNNTTHHNNHNNNTNTHNHNHNTN
TNNNBNBNNNTHNNNNHTNHNHTNTBNNTHNNHNNTNTNNTTHNNNNHHTNNNNTTNTBTNNNHNNTTNBTNTTHTNNNBBHTHTTNNTHNHTNNNNNHN
HNBTNHNHTTTNNNNTNNNNNTBNNNNNTBTTNNHNNHNNTNNHBNHHNNNNNTHNNNNNNHNNNNNTNNNNNBHNNHTBNTNHNHHNNHNBTNNNBBNN
HNHNTNHNHNNNNHTNBTBNNNTTHNHHNNNBBNNNHHNNTHTNNNNNNTHNNNNTNHNNNHNNTHNNTNNNHHTTNHNHNNNNTNNNTHNTHTTNNNHT
THNTNBHBNNNBTNHHHHNTNTTNHNNTNTTBNTNNNNTNBNHHBHNTNTNNHBNTTNTNNHHHNTBTNTNNTHNBHNNHHNHNNHTTNBNBNBTHTBNH
THTNNNNNHNTNNNBNNNNTTHNBHTTNTHHTTHTNNNHNTNHNNTNNNHNNNTHBNNNHHTNNTNTNNNNTTHTNBTTBNNNTBNTHNNNNNNNNHNNH
NBHTTNTNTNNHHNBNNNNNNNTHNHNHTNNNHHHHNNTNTNHNTTNNTNTNNHTTTTTTNNNBHHNNNNNHTNBHBTNNNHNHTNTNBHBNNHNHHHBN
