HHNNBBBHBNNBHNNHTNNHNTNHNHHNBNNNNTBNHTNNNNNNTNHHHTHTHNNNNNBTTNNTBHNBHNNBNNBTBTHNTHNNBNNTHTNNNTHHTNHT
NNTTTNNNTTHHNHHHNTTNNTNNTTNNHNTNNHBNTHNNBBBNHNNTNNTHNNTTNBHTBHHHTNNNHNHNNNNHNHNBNTHNTNBHHNHBNNNTBTNT
THHTBHHNNNHHTBNNBHTNNBHNHBNHTBNTTNNTNNNBNNHTNNTHNHTHTTHNNBTTNHBNNNNNNNHBBTNHNHNHHHBNNTNHTNNNNHHNTHHN
NNNHNNTNNNTNNNNTNBNTTBNNNTTNHNNNNNTNHTBHBNHNTNNBNHNHNNNNTNTHNTNHHNBNNNHNTNHHBNNTNHNNNNBHHTTNNNNTNNTN
NHBTNNNNBHHHNHTTTHTTNNHNNHNHHTNHTHBHNNTBBNBNHHNNNTBTNHNNHNNBHNTBNNTNNNBBNTNTNNNHNHHHTNBTTHTHHHHNTNNT
NNNNHTNTHNBHNTNBNHHBBHNHNNTBHTBTNNBBNTNNTNTHBTHBNHNHNBHNHNBTTNNNBNTNTNNNNBNHTNNNNNNNHNHHNNNNHTNNHNHN
HNHNNNHNTTHNNNTHNNNTHNNBTNNHTHTNBNHNBHTNNHHTNTBNNNNNHTNBHHNTHBTNNNTTTTBTNNNTNTTNNTNNHHHNTNTTHTNNBBBT
NNTHNNBNTTNTBNBHNNTNTHNNNNNNNNNTTNHTTNHTHHHTTNHNTBTNNNHTNHTHNHNTNNHNHBNNBNTNNNNHHNBHHHHHNHTBTNTNTTBN
NNNHTNNHNNNNNNNTTTNNHNNHNNNHNNTTHTBNTBTTNHBHBHHHNTTHHNTBNTHNNHTHHHNBTTNBNTNBBTNNNNNNBTNNNHTNNNTNHNNN
HNNBTNHNNNTHNNNHHTTNNNNNHNTNHNHNHBTHNNNNTNHNHNTBTNNNNHHTNTNNNHTBNNBTTNBNHBHNNHNNNTBTTBHNNTNHNNHNHNNT
TNTNNHNBTBNBBHNNTNNHHTHBBTTBBBNTTNBTNNTTBNNNTNBHBNNTNNNHNNHTTNNTTNTNNNNNHNBNNTNHNTNNHNTBNNNTNHBNNTNN
BNBNHBBHNTNNTTTBTTNNTNNHNNHHNNTTTNNNNTNNTNHHNNNBTBBNNNNHNHNNNTBHTHNNNTNNTHNTTHHNBHNTHTTBTHBHHHNNBNNT
BTNHNHBTNHNHHBNTTNNNHTNHTNBTHNNNHNNNNNTNHNHNTNBNTTTNNTNNBNNTNBNNNTTNNNNTTNBNNHHHNNNHNTNNNHHNNTBTBNNN
TNBNNNNNHTNTNTNNHHHTNNNHNTHHNNTNHNTTHTTNHNNNNNHHHNNBNNHHNTBHNHNHHNNTHBHHHNNTBBTNNNNTNNHBTTNTNHTNHNNT
NNNBNNNHHNTNHNHNTNBTNNNNNHNNNNBHTNNBNNTNTHBTBBTNNHHNTHNBBNNNNHHTTNNNNNHNTNNNNTHHNTHNBTHNHNNHTBTTNBNH
NNHTBHNNTHNNNNNHBHTNTHNNBTNTBNNTTHBBNNNHTHNHNTTNNTTBNNHNNHNNNBTTHTBHBTHNHBNNTNNHNTHNNNNTTNBNNNNNHNHN
NTNTNNHBHTTHNNNTHNNNHNNNNTHHBNBTNNHNTBBNNNTTHHNNNTNNNTTNTNNHNHNTTNNNNNHNTNTBHNHNNNTTTTTTTHBBTNTHTTHT
HHBTNHHBHNNBNTNNNHNNHNTNHNNNNNHBHNNNTHNNNTHNTHNTNNNNBTNHNNNTTNNNNNTNNNNHTBTBHNHNHHBNNHBBNBBNNHNNTTNN
BBBHBTTNTNHHTHNNTNNBNNNNTHHNNHBNHNTTNNNNNHHNHNTNNNBNNNNTTHTNNBTHHTNNNNTTTNNBBNBTNNBNNHHHTTNHTNTNTNNT
NNNNNNHNTNHNHNNBNNHHHNHHTHHTBHTHTNNHNHTNHTNNNTBTTTNNNNNTHNTNBNNHNBNNHNNNNHNNNNNBHNTNHBNNNNBHNNNNTNNN
NNNNNHBNNHNHTNNNTNBNNNTTNNTTTHHTBBTNHTHNHNBTNTNNNTNTNNHNNHNNNBHNTTNNNHTHBBNNHBNNNHTHNHNNTNTNTHBNTNNN
TBNTBNHTBTHNHTNNNNTNNNTNNNNTTHNNTNHNNNNHNNTHNTTNBNNNNNNBNTHHNTNHTNHTNNBNBNNBNNNTHNHNNNNNTTNTBTHNHNNT
NNHHTHTNBHNNHHNNHNTTNNNNTNNNNHTNNBNNNBNTHNNNNNTTNBBNHNHNTTNNHHHTNNNNHNTNNNNNNNTHTNHTNHNNBNNBHNTNHBTH
BHNHTHTTNNHNHTNNNTNTNHNNNNNTBNNTNNHNHNNBTNHNTHNTNTNNTHHNNTHNNNNNNTTTBNNTTHTTTHNTNNHNHTTNNBNNNNHTNTHN
TNNHTNTNTNHNHNNNNHTTHNHNHNTTTTNHNTTBNNNNNNTHBNNHTNHNNNHNHNNTTBNBNNTNTBNTHNNNHHNHHTHTNHBNTHNNBNTNNNHB
NNNTBBNHNTTTNNNNTBHHBNNHNBTHTTBNNNTNTNNHHHNNNNNHNNBNNNNHHNHBTNBNNNHHHNNTNNTNBHBHHNNHNHBNBNNHBNNNNNNT
HHNNNNNNNBNBNBHNNBNNTHNTNTTHTHNNTTTBTTNTTNTTNNNBNHHNNNBNNBHTBTTNNNNNTHNTNBNNTNNTTNTHHNNBNNHHNNHNNTHN
NTTHTTNNTNBHTNTTNNHNHHBNNTTNTHBHNTNNHHNBTTNNNNHTNHNNNTNNNNTTNHNBNNBNTTHNHNBNNNTNNNNNBNNBNHBHTNNNHNHN
HBTNNNTHNBHHNHHNNNNNNTNNTNNNHNNNNHNBHTTHNNNTNNNNTNNNNNHNBNHNNBTNBNTNHTNHBHNBNNNNHNTHHHNNNBNTNNTNNTHN
NHBHHNNHTNNNHHBNBHHHNTHNBTBBNTNTNBNNNTNNBTNNNNNNNNNBNHNTHTNNBTNNNBTNHNNNNNTNNNNNNNBNNTBNTNHNTNBNBTNN
NNNBNNTTBNTNHNTTHNNNNHTNNNNHBNTBHNHHTHHNNHNNHNTNTNNNHHTNNNTHTNNHTNHBNNHNTTTNHNBNNNTTNNNTNNHHNNTNTTNT
NHNNTNNNNBNTTTNTNNNNHNTNNHNBNNNNNBNTHNNNNBNTNNBNTTNTBNNTHTNNNHNTHHNTTTHNBNHNTTNNHNNNHNHTNNHNNHNHNBNT
NNNBNHNTNTNNNNNBNNNNNNNNHTHNNNHNHNTTHNHHHNHHTBBTTTNHNHTNNHNNNNHBNHBNNNNNHNNTHNHNNNHTNNNNTBNTHNNBBNNN
HTHNNNNNNNNNHNNHHNNNHBNNNNNNBTTTTTNNNNHBNNNHNNHNNHNNNNHNHHNHHNBTNNNTHHNNBNNNBNTNTNNNNTNHNNTHNNHTNTHN
TNNBNNNNNNBNTNHNBBNBTBHTHHNTNNNNTNNHHTTNBBNTNTNTNTNHNTNHBNHNHNNTHNNHBNNNNNNBNTNNHHTBNNNNTNNNNBNNBHHH
HNTNHNNNBHTBHNHTTHNNHTBNNBBNNTNNNTBHNTNHBNNHNNNNTNTTNNBNBBBBTNBBNHNNNNHNNBNNTTNHHBHNNNBNNNNNHHHNNTBB
NBBHTNNNNNNTHHNNNHNHTNNBNHNTNTHNNHHBTNTNNTNTNNNNHTTNNNTHTNNTHBBTNNNTTNNHNNNHTNNNNHNTNNNTBTHNHNNNNNTN
BNNNNBNNNNHNHTNNNHNTNNNBHHTNNNBBTNNNNHNNTNHTTBNBHTBNTHBBHNNNHNNNTNBNHBNNNHNBNHNBNNNTNHHNTBHNNHNNNHHN
TNNTTNHTHNBTNNNTTBTNNHNTNHTNNNBBNBNNNTTHTHTHTHNNTBTBBNNTBNHHNNHTHNHNTNNNNNTHNNTNNNNNNNBHBNHNTNHNTTBH
NHNNBBHNNNHNNTNNNNHNHNNNTNNNNHNHNHHNBBBTNNTNHNNNTNNTNNHNNNTBBBTNTNNHHNNNNBNNHNTNNBHNNTTNNTBNTBNHNTTH
NHHTHNTNNBNHHNNNNTBNHTHHNHNNNNNHHHNTNNNBNTNNNHNNNNHTBNNHNTTTTTNNBTHNNTBTHNNNHTNTNNTNNNNTNTBNNNHHHBHH
THNTNTHNNNNNTBNHHBHHBHNNNHNNNNTHTTHHHNNNBNBNNTTNNNNHNNTNHHNTHHNTNNHHBNTNTNTNHTNNNHHBNTNBNNTHNNHNBNNT
HNBTHBHNHHHHHBNNTNNNTNTHTNNBBNNTNTNNNTBTNBHNHNNNHNBTNBNHTTBBTNNBTNTNNNNHBTTNNBNHHNBHNNNTBNTNNNNTNNNN
THNNTNTNHTTNTHTTNHTNTHBNHHBNTNNTBNNNNNNBNTTTNBHNTBHTNHNNHHHNNNNTHTNNHNTTNNBHNNNBNNTNTTHNTHBBTNHNHNNH
HTHNTBBTNTNTNNNHNNNTNNBNNNNNNHHTTBTNNHTBNTBNTNNHHNNNNNNBNNNNBNBNNTTHNBBHHHNNHTNNNNTNNNNNNHNNTNNTBBNT
HNNNBNNBNNTNNNHNNHNTTTHBBBNNBNNNNTNNTBBTTHNHNNNBNTTHNHHTHTHNTTNBNHNTBNNNBTTTBNHNTNBHNHNNBTHHTNNTNNHN
BNHBTNNTNHTTNNNNHNHHHTNTNNTTTNTNBTTNHNBBNNNNNHTNBNNTBNTHNTHNBHHNHNNNNTTTBBNBHNTHBHTHNHNNNNTHNNNTNHNH
NNTHNTBNNTBNBNNNTBHHNHNNTNTTTBNNNBNBNNBNTNNBNNTNHNHBHNBHNHNNBTTNNNNTNNHNNNBHNNHNNHHHNNTHTBTHHNBNNHNT
NHTBBBHBNHNNTNBNHHHNBNHNNTNBNNTNNBNHTNNNTNNNNTNNTHNNTNTHHBTNNNTTNHTNTBNHHHHHNNHTBBNNTNNBNHBNHHBHTHNN
BTNTNNHTNNNTNTNBNNHBNTNTNTNBHNNNTNHNHNTNNNNTTTNTHTHNHNNTTTNNNNHNTHNTNNNNTTNNNNNBTTNHNNNHNBNNNHTNNNNT
TNNTTTBTNNTNTNNBNNNHHHHNNNNTNNNTNNBNHNBNBNHTTHTNNTHNNNNNNNNNNTTHNHNNNNNTHTHNNNNHBHNTNNNNNNNNHBHTNNNT
BNHNNNTNNNNTNNNNBNNHNNHHNNNNNNNNNNHNTNHHTNNNBNTTNNTTNNTNNHNNHHNHNNHNNTTBNNNTNBTNHNHTNNNHNNNNBNNHTTNN
BHTTHTTNNTHTTNTNBHTBTNNNHBTTNBHNTTHNHNHNNTNTNHHNHNNNNHNHNHNNNHTNHNNNBHBNNTNNNHBHNNNNNHHNTNNNNNNHNTNN
NNNNHTTNNTTNHTTTNNHNTHNBTTNNTTBTTNTHNNNNNNTBBNHNNNHHHNHNHNTHNTNNTHNTHTNBBNNTNHHNNTNNTNHNTHTBBNTTNNNN
NNTHTBNHTBNBHBHNTNHNNTNHHTBHNHBTNHNBTBBBTNNTHHBNNTHNNNHTBNNNNNHNNNHHHNBNNHNHNNTTNNTNNTNNHNTNBHNNTNBH
NNNNBNNNNHNTHNTNTNTNNNBNNNNNHTHNNNHHNNHHNNNHNNHNBTHHHHHTHNNNHNNNBNHTBHHNNNNBNNBTHHTHBNNNBHNBNHNNNNBN
TNNTBNHNTNHNTTNBNBNNNTTTNHNNTNNNNHNNNNHBNNNNNNNTHNNNNNNNNNHTNNHHNHNHNNHNNHHBNNNNNNNBBBNNNNNBNNHTHHNN
NNNBTHNNNNNTHNTNBNTBBBHTNTNBBTNTHNNNBNNNHHNNNTTNNBBNNNNHTBNBTHTBTNNHNNTTNNNNNTHNTBTBNTNNNTNNBTNTNBNN
NNHNHNNHHNNBNHNNTBTNHNTNNHNNNTNTNNTBNNNNNTNNNNHNTTNNNNHBNNNNBHHTNHHNNTTNTNHNBNNTNTNNTNHNHBNTNNBNHTHB
NHTNNNNNNNNHNNNHNHNHTHBNNHHTNNHBTHBNHTBHNNTTHNNNNBBHTTBNTNTTNNHNNTNHTNNNTTNBNTNNNTNNNNHNNHTNBTTTNTNT
NTHNHBNNNBBNNHNNHNNNNHTNHNBBNBNHNHTHNTHHNNNBTTNNBTNNHTNNNNNNTBNHTTBBHTHHTNNNTNTBNNNNNHNTNNNHNNNBHBNH
HBHHNBNTNTBHTHTTTNTNNNNNNNNNNTBNNTNTNNNBTHNNBNHNHHNNNNNTNNTBBNNTHBNNNHBNNHNNTNNNBHBNNNNNNNHTBHNNBNHN
TTBNNNBTBNNNNBTNNTTNBTTTNBHHHNNBNNHHBHHHNNHBNNHNHNBTTNNTNNNHTNNNTTNTNNNTHNTHHHNBTBNNTHTTTHNNTTNNTNNN
HNBTHHNTHBHHNTNTTNNNNHNHNNNHTTTHNBNHHTNHHHNTNHNBTTNHBNNTHHBTHBBNHNTHNTHHHBHNNBNTHNNHHNTHNHTBNNNHNTTH
HHNNNTNNTNNTTTNTNNTHTNNNNNBBNNHBTNNTHNTHNNNBBTNTNBNBNHTNHNNHNNNTBTTNNNNTNNNHNBNNHNHBNNTNNHHNNTNBHNTT
NNBTHHBBTNNNBNBHNHNNNHTHTNTNTNNHNHNNNNNTNNHHTTNHNNNNTNNHNNTNHNNTNNNHHNHTHBTNNBHBNHNBNNTHNTNHHBNNNNHN
HNHHNNHTHNNNTNNHTNTTNHNHHHNNNHNNTBNBNNHNNNTTNNTNTNNNNNNNNNNHTNNNHHNNTHHHHNTNBTHNBNHTBHNTNNNHNHNHBHNT
NBHNTHTBTTHTNNNNHHHNBNHNBNTNTHHNTNTNTBNNBNNTTTNHNBHHHNTTNNBNTTHTBBNBTBNTHNNHNBTBNNNHNNBHNNNNNBHHHNHN
NNTNNHBNNNBTNNHNHNNHBNHTBNTNHNNHNNHNTNTTNNNNNBHNNTTHNHTHBNNNNTBTTTNBNNBNTNHHNHNBHHHTNTNNNNNNNHNTHTNT
TTNTNTTNHNHHNNHNTNNHNHTTNNNHNNHNNNNBBNTTNHHNTHNNTNHTNHHNNNNTNBHTNHTNTTHTNHNBHHNHHBTTHBTNBNNTNHTHNHTT
NNNTNNTNNNTNNNTNNNNNNNNTNNNBNNNHHHTTBHTTHHBTNTHNTHNHBHHNBBTNNHHHNNNHNNNNHHNTNBHTTBNTNNNTTTNTNTHNNNHH
NNNHNNTNBHNNHBHTNNTNTHNNNNNBBNTNNNNNNHHTNNTHHNNNTNHTNTHNNHNNNHNTHTNHNHNTNNNTNNTHTNNTNNNHHTNHBNNNNNNN
NHNHHNHNNHHNHTTNNHNTNTTTNNNTHNTNNHHTNHBTNBTNHNNHBHNTBNTTNNHHNNTTTTHNNTBNBNHNNHTTBNNTHNNTNBTNBBNTTTNN
NNNNNHNNNNNTNNNNHNNBBNNHNNNBNNNHNHTNNNHTNNNHTTNBNNNNNNNNNHNNNTNNNHNHNTHHTNHHNHNBNNHNHHNTTTNNBNNHHNNT
BNTNNHNHNNNNTHTHHHHNHBNHNTBHNBNNNTTHNNNBBNBHTTTBTNNTTNTNNNNNNHBNNTHNTNNNTNNNBNNNNNBBNNNNTTNNHHTNTHHN
TTTNHNTNHNNNHHHNTNHTNTNNHNNHNNNTHNNNNTBBBNNHNTBNNNNNTNNNNNNNNHHNTTNNTNNNBBTNTNNNHNNNBHNHTBTNNNTHHNNH
TNNNBNNHTTHNNNBNNNHHHNTNNNNNBNTTHHBTHTHHHHNHTTHBNTNBTNNNNHHTTNHTTNTTHTTNNNBNTNBNNNNNNNNHNHNNHTBBHNHH
NNHTNBNNHTNNNBNNBHNNTNNHTNTHBTNHTHTNNTTNNNTNNHNNNNNNNNNTTBNNNNHNHNTTHTHBNTNNNHTNTNHBTTBNNHHTTHNNHHHN
NBNHBTNBHTTTHNTHNBNNNHBNBNTBTNNHTTNTNBNHTNNBTTTNNBBHNHTTBNNNNNBNNNBNNHNHNNTNTBHNNHHNHNTBTNTNNHHNTNNN
NTHNBNTNNTTNHNNNHNTNTNBNHNNNNNNNHNNHBTNNHBNNNNHNTNBTNNTTNHNNNNNTNBTNNHHHNTNHTNNNNNTTHBNHHNNBHNNNTNBH
NHNNNTHTTTTNNNNTNNNTNHNHNHNTNNNNHNTNNNBNTHHNNBNNNHBHBNNBBTNNTNNBNNNBTHTNNNTTNHHHTNBNHHNNBNTNTTTBNBNB
BHNTTTNHHTNHNNTHTNHBNTNHTNHNNBBHNHHNNTNNTBTHTHNNNBHTNTTNTNBTHHHNNNTNHNBBNHTNNTNNNHNBNTTTBHNTNBTNNTTN
TBNNNHHNHHBTNTHTNHNTTNTTNNTHTHHNNNNTHNHNTNTNHTTTTHNBHHHNHHNNNNNNNNTTTHHNHTBNNBNHNTNNTNNNTBNBTTNNNNBB
NNNNBNTNHTNNNNHTTTNTNNHNTNNHNNNTHNNNHBNNNTNHNTHNBNTNHTNTHTNHNHHBBTHHNTNNTBBTTNHNHNTNHTTNBHHNNNHBNHBB
BNNNHNNNNHNNNNHHTNTHNHBTTNHHTNHBTHBNNHNBNNNTNNTNNNNBTBTHNNNBTNTBTNHHHNTBNBHTHNNNHHTNNNTNNNNHTTBNHNNN
HHNNTNNNNTNNNBNNNHBNNNTBTTHNNNNBNNHNHNNNBTNNNNTNNHTNNHTNHHNBBNTNBBHNTHTHNHNHNNTNNNNTTNNNTNHNNBNTTTNH
NHBHNNBTTHTHTTNHNHNHHNTTNNTHNNNHBTNNNNBBHBTHNNNHBNNNHHTNBTHNHTHHBNNNHTNHNNNNNBHTBHNNNHNNNTHNBHHTNHTH
NNNTHTNNHTNHNHTTTHTNHNNNBNNNHNNNNNNTNTNHNNNNNHNHTTHTNNNTNNHTTHHNBTNHNNNTNBNNNNNTNNNHHHNNHNNNHNTNTNNN
HNHHNTHNNNNNNNTNNNNNTNNTNTBTHHHTNHNHNBHNTTNNNTBNNNNTNTHHNNHTNTNNNHNHNNTNNHNTNTNNHTTNNNHHNNHNHTNTNHTH
NNHNTNNHHTHHNHNNHHTHNHHBNNNNNNNNNTHNNHBTNNNHHNHTNBNNTNNTNNBBBNHHNNBBNBTNTNBNNTNBHBBTNBNNTHNNNNNNTHTH
HNHNTNHHNTBNTHTNHTBHTHHTNNNNNHBBNNHNHTHNNTHNTNNHHNBNTBBTHNHNBNNNBNHNTNNBNNTNTBBHTTHNHNNNHHHTBBBHTNNN
NNBTNTNHNNHNHTNTNNTNHTBNTNNTNNTTNTNNNHNNBTNNTTNTNTHTHTHNNNNNNNTHTTNHNBNNBBNTHHHNHBBBHNNHHTNNNNHNNNTH
NTNBNHHTHHHNNBHHNNHTHTNNTNNNNTBHHTNBBNNTHNTTHNNHNBHHNHTHHBNNTHHHNNNNNTTTBNHTHBHNHNNTHNNHHNNTTBNHTTNH
NNNNTNNNNNTNBNNNNNNBNNBNNHTHNTTHHNNBBTHNBHNTHNNNNNHNNNNHNNHTNNTNTHNNNHNTNHNBNTNHNNNTHBTNHHNHNTNHTTNH
TTTBNTNHBNHNNNTTHNNTNNNBBHNTNNHNHNHNNBBBHNTNHNHNHHTHTBBTNNNHNHHNNTNHNNNNHNNNNNHNNHHHHTNHTNNNNNNHBBNT
BHNBNTBBNNNTNNTNNNNNNHHNHTHNHNHNNNTNHNHHTTTHNNHHTNHTNNHHHNHTNNNNNHHTNNNHHNNNNNNBNNNNTNNTTNHHTHNHNNTN
NNNHNHNTNNTNTNBNNTNHHHHNBNBTHNTNNTHBHNBTNNNTNHBBNNTNBBHNTNNHTBNHNNNNTHNHBNHNTHTNBTBTHHTNNTNBNNNHNTTH
NNNNNNTNNNHNNHNHNTNTTBNBNBNNNHHBTTHBTNTHBNTNNNHNBTTBNBNNNNNHNNNNTNNNTNNTNTHNNNNNNBTNNHHHNNTNTHBBBHHH
NHNHTNTNHTHHHHHNHTNBNNNNTBNNTHNNNNTTNNNHNNNNTBNTNNNNNTNNHHHHNNNTHNNNHNTNNNHTBNTNBNNBNHTHHTNTBNHTHTNT
TNBNHNNNNNHNNTBNHTBNHTTNTTHNNNBNHHNNHNNNBTNHBTHNTNNNHHNNTBBNNNHNNHNHNHTNTNHHNNNNTTNNNNNHBHNTHTNNNHHH
