NHTTBHNHNNNTHNBNNNNNNNNNTTHNNNNTTNHNNNHTNHNHNNNHNTNNTTHHNHNNTTHNHTNNBNHHNNHTNTNNNHNNNNHNNHBNNNHTHNNN
NNNNTNNNHNTNHNNBNNNTTNBNHTBHNNNNTTHNHNNHNNNBHHNBBNNTBHTTHHNTNHNNNTNNHNHTNBNNNTHHNNNBBBNBTNNBNHTNBTNH
BNNHNNHTHBTNTBHTNBNTNNHNHNNBHHTHNTHNNHHTTNBTNNNNHHNTNNNNHNNNHBTTNNNTHNHNTBNNNNNNNNHHHHHHBBNHHTBHTNHN
BNTNNNNHTTNBNHNTHTNNHHHHTNHNNHTNTBBNHNHTHNNTNHHHNNHNNNTNNNNNNNTNTTNNHTNNTHNHNBHBHHNNTHTHHNTNNNNNNNNB
HTNTNTNNNNTHNTNBNTNTNNNTHTNTNBNBTNTBNNNNTHTNBBTNNHNHHHTHNHTNNNNNBHTNHNHNHNTHHNNTNBHNNNHNHHTNNTHNTNNN
NNHNBNTNHTBHBHNNNNNNNHBBTHTHBTBHBNNNHHNTHTNNNNHHHNHHNNNNHNNNTNBNNNTNNHHNNTNBNNNNHHHHBNTNTNBTHNNBNHNB
NHNBHHNHNHHNTBNTNHTBNHHTNBNNNHNNNNBTNBHNHHNNBHTTHTNNNNHTBNTNBNNHNHTNNHNNNNBTNTBNNBTHBTNNNNBTNNNTNBHN
BNHNNTTNTTNBBNTTNHNTNTBNNHNHNNNBNTNNTNNHNNHBTBBHNTNHBNHNNHNHHNHNBHTNNNNNHTHTNHTNBTHTTBNNHHTBNNTHNNNB
NTNHNTTHTNTNBHNTNNNNTNBBTNTBNHNNNHTBHTNTNNNTNTNNTBTNTNNTNNNNNHNBTHTNNNHBHNNNTTHNNNNHNNBNHHHTNHNTTBNN
NTTNTTNHBNNHNTNNNTNNNNNBNHNBNHBNTNBNNNBNTNNTNTBTHNNNTTNNTNBNHHNNBNNHNHHNHTTNTNNNHHTBHNNTTHNBHNTTNNNH
BTNNTNNTTTHNHBBNNTNNNTNTHNNNHNNNTNTBTBBNTNHNTNBNTHNNNNNBNNNBHHNNBNTNNNNNHHNTBTHNNBHNBTNNNTHNNHTBTTBN
BHNNNHNNHTBNTNNTTTNNTNNNBHBNNNBHNTHHBNTNNNNNNTHNNNNTTNTHHNNNHNNNNNNNNBNBNTNNNNNTNTNNHNTTBHTTNNBNNTNN
TTNNNNHNHHNHNNBHNHNBNTNNHTBNNNNHNNNBBTHNHNHNHNTTNNNNNTNNNNTHHTBBNNNNNNHTNHNNHHNNNHHTTHNTNNNNNNTBNTNN
TBHTNNNTNNNNHHTNHNBNNNHNNNHHBNNNHBTNBNNHNNNHHBNTBTTNNHNNHHHNNHNTHTHNBTNNNBNTNHTHNTBNHTNTBTHTBBNNHBNH
NNTHNTTBNNTHNNNHTNHNNBBTNNNHNTTNNNHNNNNTNNHNNNNBNNNHNTTNNTNTTHBNHBNNNNNBNNTNNNNHBTNHTTNNHNNNNNNNTTNN
TNBHHNNNNHNNNNNNNTNBBNNNNNHTNTNHNNNHNNNTTBHNNBHNNTHNNNNNTTNTHBHNHNHTNTNHNNTHNTNNTNNNTHHBNNNHNHNNHNTT
NTTTNNHNNTTNTBNNHHNBNNTHNTNHNNNHNTTBNNNTTTNNNBBHBNTTNNTNHBBNNHHNNNNNTBTNBNNHTTHTTNNTNBNTNHBTNNHNNNHB
NNNNNNNNNNHNHNTNHTHBTNBNNNNNBTHNHTBBBBHNHHNNTNHBNHHNTBTHNNNBNHTTNNHNNNNHNNTNNNTNBNNNBTNBNNBHHTNHNTNN
TNHHNNHNBTNNNNBBNBHNNHHNNNNBNNHNTNTHTNTTHNTTNNNNHNNNNTHBTTNHNNBNNNTNHNBNNTNNTHNNNHNNBNTNNNBNHNHNNTNH
HNNHNTHNBHNNNNBHNNNHTHNTHHNHNNNTNNNTNBHHNTTNHNTHNNTHNNTNHNNNNBNNNNNBTTNTNTHNNBNTBHTNHTHNHNBHNHNNNNNN
NNNNHNTTBNNNBNHBNNHNNNHBTBTNNTNHTNHTNNTNHNHNNBNBNHTTBBHNBTNNNHNHHTBNNNNHTTNHNNNHHTBNHNTBHTNNBBNTHHNB
HNNBBHNNNHHNTNNTNBTNBNTHTNNNNNTTTNNBHBBNBNTNNTNBTNBHHHHHNBBNNNHNHHNNNNBHHNNNNNBNTNNTNNTNTHNTBNBTNNNH
HNHHHTNNTNNNNNBNNNNTHNNNTHTHNTNTTNHBNHNNNNBNTTTNNBHNNNBTBTBNBNNNNTHNNNNHTNTTNNBTNNNTHNTNTNTHNNTTTNNB
NNNNTTNHHBNHNHNHHHNNNHNBHNNHNTTNHHNHTNNBTNHHNTNBNHTNNNHHNHNNNNNTTNNNNNBNTHNHHNBTTNTNTTTHBNHNNTTTNNNN
NNHNNBNHNNNHHNNNHHNNHNHNHHNNHBHNNHNNNNHBHNNTNTNNNNHNTTNNTTNNNHHHNNHNNNNHNTHHNNNBTTHNBNNTBNHTBTHTNNNB
NHNHNHNTTNNHBHHNNHNHNNNNHNNHNNNNHNNTHHBNTNNNTNNHNNNTNHHNNHBNNNHTNNHNNNNHBHHNHNNNTNBNNTTTNHNNNTHBNNNN
NHNTHNNTHHNTNTTTNHNHTNBTNHBNTNNBHBHNTNTNHNNBNNNTNNNTNNHNHNNNNTNNNNTHBNTTBTHNBNNNHHNHTHBNNNNNTHNNNNTH
NNHNNHNHNNNTNHNNTNNNBHNHTTNNNNNHNTTNNNHNNNTTTNTTHHNNHNTNNHBNTNTBNTNNHNHHHNHTNHNNNNTNNNTTHNTNHNNTTNNB
NHNHTNNTBTTNNBHNNBHNNHNHNNNTTNTTNHNNTNBNTHNNNNNTNNTTHHHNBHHNNHNTNTTNNBHHNNNHTNNNBHHTNNNHNTTTNHNNHTNT
NTHBNTNHNNNBBTTTNNNNHNNNTTTNNHNNNNHTTBTTNHHNTTNNHNNNNBNNHNNTBHHBHNHTNHNNNNHNNTNTHNBHNNHHHBNNHNNHBNNT
NHNHTNNTTTHNNHTNNHHNHHHNTNNNNNNBTTHNHNBNHBNBNNNNBNNBNTHTNNHBTNNBNTNNNNNBTNHNTNNNTNNBNTNNTNNTBBHBNNNN
NBNNNNNNNTHTNNTNNNNTNNNNNBNNNTNTHNBHNNHHNTHHNNNHHHNNNTNTHNNNNBHTNNNNNHTTNTNTNNHTBTTNBHBNHHHTHHNNNNHN
BNNNTBNBNTHNNTNTTNNHTNHHBHNNTHTNHHBNTNBNNNHBBTHNHNBNNTTHNBTNNNHHNNTNTNBNNTHNTTTNNNTTHNHTHHNTBBTNHNNN
NTBNTNNNTNNNBNTNNBTHTTTNNTBNHHHNHNTNNNHBHTTNNNNHNHBHBNHBTHNNBNTBNBBNHNNNNNNNNTNNNNNNBNNNTBBNHHNNNTHT
NHTNHNNNBHNNHTNNTNNNNNHNHHNNTNNTNNHHNHTBHNTHNTHHHNHNTTHTHNNTHNNNHHNNTNBNNNNHBTHNHTNNHTTHHNHTTHNBBHNH
BNNNNNHTTNBHNNBNHBHNTTNNHNHBTTHHHNBHNNNNNTHNHNNNNNHHNTBNNNTNNBNNNBHHTTNNNNTHHNTHNHHHHNNNBNHNNNBNHHHH
NNTTNNTNNNNNHNNTHBNNTNNNNHNNNTNHTTNHTTHNNHNHTNTNHHNNNNNHTNTHHNHHNBNHNNHNTNNNNTNTBHTNHNTBTNHNNNBNHNHN
TNBTNBNNHBNNHNTTNNHNTNNNNNNNTNHHNHTNNNNTNBNNBNBTNHTBNTNBNHNNTNNTNBTNBBTHNNBNNNNNTNNTNNNNHHTNHTHTHTNH
TTNBBHNTNNNNNBNTNNHNNTNHTNNTNNNTNNNTHNBNNHTTTNNNBNNTNNNNTNHNNNNHBTNNTTHNHNBNTNHHHNNNTNNHNTNNBNNTTNNH
NNBNNHBNNHNBNHNTHNHHNNTTTNNHTHNHBNNNTNTTHTNNNNNNBNHHBTHNNNBNNNBNNTHHTNNHNNHNHTTNNNTBNHTNBNTHBNBTNNTN
NNNHNNNNHBNNNHNBHNHNTNHHNNNNNNBNNTBNNNHNNTTHNTHBNNBNNTNNHNHNNHNHTTNNHNTNNBHTNHNNHNBNNTHHNTNNNTHTTTNN
NHTBTBNNNBHNHTNNNBTNTHNHNNNHTNTHNNNHNNTTBHHTHNNNNNHHHNNNTBNNNNTHTNNBNTNTNTNNTHHHNNNHTNNNNNNNHNNTHHHN
NNNNNBTNHTTNNNNHHTBTNNNBHTNTHNNNBTHTBNHHTNNBTNNBHTHNBNNNHNBHTNTNHHTNNNHTBNNHTTNBHNNNNNNNTNNNTHNHNHNN
HNNNNNHHNNTNTTNHNHTTHTHNTNNHNHNNNNNNNNNHNHHNNNHNNNNNNNHNNNNNTHNNHNTNHNTNNTNHNTNNBNNNTHNNTNNBHNNHNNNH
NHNNBNTBHHNNNTNNTTTNNNTBHNNNTNBHNBTTNNHTTNNHHNHBNNNHTNNNNNNNTNTHTBBTHHBNNNTNNBNBTNHNNHHHTNHHBTNNBNTN
NNTTNNHHNHTTTNNNNNTNNNNHNHHTNNNTNHTTTNHBNHHTNNNTHTNHNHTTNTNNHTHNNNNNNNHHNNNNNNNNBBTNHNNHNNTNNNNBNBTT
BNNHTTNTTNBNNTTNHNTNBBHHNNNNNHNNHNNNHNNNTTTHHNBNNTTNHNNBNHBHNNTTNHTNNNHNTHHNNBTNHNHBTHNNTNHHNNNNBHHT
TNNTNHHHHNNTNHHHNBNBTNNHTBTHNTTTBHHBBTHTNNBHNTBNHNHNBBBNNNBTHTHHNBHNNNBNNNNTBBNNTNNTNNNTTNTBHTHNTNNH
BHNTTNBNHNHBTNNTNTBHNBNTHTNNNNNTTNTTTNTNTNHHNNTNTTTTNNHTNNHNHNHNHNHNNHNNTTNNNNNNNHHNNNNTNTNTNNNNNNTT
NNBNTNNNNNTNBNNHHNNNNTHNTNNBBTTNNHTHTBTNNNTTNNTNNNNNNTTNNNHNBNTHHNHNNNNNHNNBNHHHNTTNHNNNHHNHNNBNNHHB
NHHNTNNTBBNNTNNBTTBNNHNHNTNNNBNBNTHNNTNNNNNNNNTNTNHNNNNNTNNTNNNTBNHTHHBHNBTNBTNBHNTNTHHHNNHHBTNNNNTB
HTHNTNHHNNNNNHHTTHNNNNNNNHHTHNTNTNTBTBBNBHHNNNHNTNHNNHNNNHBTTNNNHNBNNNHTNNNNBTNHHNHHHNNNNHHNNNNTNHBN
NNNHNNHNNBNTNTNNHNNNNNHHNNNNHTNNBNNBNHNNNNBHNNNTNTBNBTBHTNTNHHHNTNNBNNBNNTTHTNTNNNHNNTHNHNNHNNTBTTHH
BNNTNHNNNNNHNTNNTNNNNHBTNTTNTTTNHNNHHNBNNNTBHNNTTNTTTNNNTBHNHNNNTBNTBNNBHNNBBHNNNTNNNNNNNNNTNNNHBTTN
NNNNNNNHNBHBNHBHNNTNNBHNTHNTNHBNHTBTNNNTNNHNHNBTHNBNHBNNNNTNTTNNNTNTNHHBNNNBTBNNTNNHHNTNTNNHBNTHNNNN
NNNNTTHBNNHNNTNNNNNTNNNHHNNTNNTNNNNTNTTHNNNHNNNNTNHHBHBNNNNNNNNNBHBBBNNNTHTNTTHNBNNTNNTHNHNNNNNHTNHB
NNNNBBNTTTTTNNHTNTBNTNNNTNNTNNNHBNTNNNTNBNNHNBNTNTBTBNNNNNTBNTNHTTHNTNNBHNNTTTNNNTNTHNNNHNTHNNTTNBTN
THBNHTTTBNNTTHNNNTHNNNBBNTNHTHNNNNNNHTHHNNNNHBNHNNBNNHNNTTNTNNNNTTBTHHNNTTNNNHTHHNNTNHNHNHNNNNTBNNTN
TNHTTNNTNNHNHNHNTNHNNHNNHHNNBNHNNBNNHTTTBNNHNTHBNNNHNTBBTNTNNNNBNHHNNNTNHNTNNBTNTHBBTBNNTNTNNHTNNNNT
NHNBTHTTTTTTTTTNTHNNBBBHTTNBHHNTNNNNNHBHTNTNTNNNTNNNNNNHHHHTNNNNNNHTTBHTNNNHNTNBNNHNHTHHNBNHNHNNTBNN
TNNBTNTNNTNNNNHTBNBBNNNNNHNNNNNNTHNNNNTNHBNNHHNBHHNNHHHNNNHNBNTNHNNTNNHBNNBTTHTNNNNNNNHNNTNBTNHHNNNN
HNNHNNNHBNNBHNNNNNNNHHBNNNTHBNBTTTNNNNNHNTNNTNTTHNHNNHNTNBNNNTHHHNNNNHTTNNHHTNHBBHNTTBNNNBHHTBHHHNHN
NHNHTNTHNHTTNBNNTNNNNTNHHHNNTTNBTNNHHNNNNHNNBTNTHBHNNNNBHHNHHHNNNHNNNHHNNTNNNTTNNHNBNNNHHNNNNNTNNHTH
HNTHNBNHTNNTTNNBBNHNNNTNHTTTNTNTTBNNTNHTTNNNNNBHNBBTTHTNBNNNNNNHNTNNNNTNBTNHNNNNHTNNHNHHBNNNHTBNNHNH
BNNNNNBNNNBTHTBHNHHNNNBNNBNNNHNNBTTTNTNNHNNTHNHHNBHBHNNNTTBHNNHNTNHNNHNHBNNTHNTNNNNNNTNBHNTNBBHHTHNN
NNNNTNNNTNNTTNHHHNHBHHNNNTNNNTNNBTNNHNBNNNNBNNNHTNTNTNNHNNNTTNTBHBNNNHTHBBHNTNHBTNNTHBBBNNNTTBNBHBBH
NHTNHNNNNNBNHNTNHTHNNTTHHNTNBNNBNBTNNHTNTNNNTNNNTNHBNNHNBTNHTNNTNNNHNNNNNNNNHTHNTNNBNBHHNNNHNNTNNBHN
NNTNNTHTNNNHBTTNNBNNBNBHNNTNNHHBNNNNTNNHTTBTTTNNHNNNTTHTNHNHNNNNHTNNHTNTBNNTTNBHTTNNNTNNNNTNNNBTNTHN
TTNHNNTNNNNNBNTTNHNNNNHHNBHNNNTBTBTNNTTNNTTNNTHNNHBNHNNNTNHNTNTNHBTNNTNBBNTNNNTNBNNNNNTNTNTNNHNHNNTN
TTNNNNTNNNNTNTNNNBNBNBTNNNHTNNNTNNTNNNNTTHTTTBNBTTHNTHTNTNNHNNTNNBNBTBNTBTNNBHTNHNNNNBNHBNBTHNNHHNBB
NHNTHNHHNTBNTNNHTHNBTNHBNTTNBTHHBNNNBHHHNNNNTNNNTTNNNNNBBNNHBNHTNTNNBNNNNTBHHNNNHHTNTNNHHHTNNHHHNNTT
TTNTNTNTHNNBNBTHNNTHTNNNNNHNBTTNTTNTHNBBNNBTHNNHNTTTHNBHTTHHHNTNBNNHTBNTNNNNHHNNBNNBNNNTTNBHBHTBNNHB
HHTTNTNNHHNBTNNNNTTNHBNHNNTNNNNNHHNHNNHTNNNNNHNNTNNTNTNBHTNNBTNNNTNBNHNNNNNHHNTHTTHNTNTNHTBHBNBBNNTB
NHNTHNNNHBTNBNHNNNNNTTHTNBNNHTTNNNNTNNBNNNTHNNHTNNTNBNBTNNHNTNTBHNNTHTHHBNNNHTTTHNBNHHTTBTNTNNNNNTNB
NBNNTNTTBNHTHTNTHHHNBBNTHNTNNHNHHNHHNHNNNTTBHNTTHHHNHHNBNTNHTNBNNTTTHHNBTNTNTNHTNNNNHNNNTNBNNNBNNHNN
HNNHNHNTNHHNHBTNNTNHTHNHNHNBHBTBNHHNNNBNNNNTBTNNNNNHHTNNHNBNHHHNHNBBHBNHNNNNHNTNHTTNTHNNNNTTNNNHNNHB
NNTNNNHNNNNHTNNNNNNHNTBHHBTHHTTTHHNBHTNNTNHHBNBTTNNBTBNNNNTHNNBHHTNNBHNNBNTNBNNNTHTNNBNTTNBTNTNNNNNN
TBTNNHBHNHNNNHTNNBNNNHNNNTNNNNBTNNNNBBTNHNBNHNTTHNTNNNBBNNHNTNNNHNNBHNHNHTTBNTNNTBHNBNNNNNBNNTNBHTNN
BNNNHNNNNTNNTNBTNNNNBNNNHHNBNNHHNTBNNBNNNNHNNHNHBNNNNHNNHTHNNBNNNTHHNNBHHTNNNHHNHNBNTNBHNBNNNHBNHNNN
TNNNHNNTTHTHTHNNHNHNNNBNTTNBTHNTNBNHBTNHNHNNTTTNTNTNNNBHHNHNNNNNNHTNHNTTHNNNHHNBNHBHHNNNTTHBNTBNNBHB
NNBNNNTHHNHNNTNNBTNNNTBTNHHNNNHHTNNTHHHBBNNNTHHNNNNNHTNNNTTTNNHBBTNNBNNNTBHTNNHNHNNHHHNNNTTNBHHTHNHH
NTNNNHBNNBHNNNNNTTHTHTNHHNTTBNBNNNHNHHTNHBNHNBTNNNBHNNNNNTTNHNTHTHHHBNNNNNNTTNHHHTNTNNHNHNNHHNHTNBHB
NNNNNHNTTNTHNNHTNHBBBHNNNHHHNTNHHBNTHTHNNTNHNNNHNNHNNTHTNHTNTHTBHNNTTNNNNNTNHHNHHNTHNNTNNNNNNHNNNNNN
TNNNNHNBNNNTNTHNHHBHNNHBHTNHBNNTNBHTTHTTNHTTNNTTTHNNTNHHNBHBNBNNNBNHBNTTNNHBNTNNHNNNHHHNNBNBHTNHBNTH
NNNTNNTTNNNBHNHNHNNHNHTHNNNNTHNTTTTTTNBNNHNHNHNBNTTBTNNNTTNTHNNHTHNNNNNNHNHNNNNHTNTTNTHHBBNNNNNNHNNN
NNBNTHBTNNNHTNNNNNNNBNNNHHTNNNHTTTBHNNTTTNNHNBNBNBNTNHTNBNTNNHNHNNNHTNNNNTNNHHBHNNNNNNNHTNHNHNNNTNNH
BHTNHTBHNNNNHNHNBNNNNTHTNNHTTNNNNNNNNHTNNNHHTNNNNNTNNHNHNNTNNNHHTTNNBBNNNBHNNBTNHNNNNTHNNTHHNTBNHNBN
NTTNTNNNTHTNNNBNNTNNNNNNTTBNHNHHNHNHNNNNNHHHNNHNTNNBHBNNHNNNTBNNHHNBTBTNNNBHNTTHTNNTNTNNNNHHNHHNTNNN
NHHBHNNTNNNNNTTTTNNBTTNHHHNTNHTBHNTNNHBHHNNTNBHTTNTNTBHNHNNNNNTNNBHNNBNNNHNNNNTTBTNBNNNHHBTNNTHNTTNT
BBBNHNBHTBTTTNHNNNNBNHBTNHHNNNNNNBTHNHHNNNNNNNTNNNNTHTTTTHNNTNTHHNHNTHNTNNNTNBNTNTNNTHNHNNNBHNNHTBTH
NTNNNHNTTNTTNNNNNNNNBNNHNTNNNNHNHHNTNNNNHBNTTNHHNTTHHBHNHNTTBNBBNNTNNNNTNNNBTNNNHHNNTNNBNNBTHHTNNHNB
NTHNNNNNTTTNHNBHBHNNNNNHNNNHNHBNNNHNHTNNNNNNHNHTTHBNNNNTTNNTNNBNNTNNNNHTNHBHNBNNBNBTNTNNNTNHNNNHHTNN
HHNHNBHNNTNNBNBTNTTNTNTNTBNHHNNNTHTNNNNNHNNHNNHNTNHNTNNNBTHHNTHNNTNNNNNHNBTHNHTNHTNBHBBHNNBHNTHNNTNT
BTNNNNNTNHNNTHNNHHBNNNTTHNHHNTHBNNTTHNNHNBNNHTTHTHNNHBTNNNTHHTNBNTNNNTNNTNTNTNHNTNTNHTNNHHNHNTNBNNNN
NTHNNHBTHNNNTNTNNNBBNHNNNHHNHTNHNNHNHNNNHNNNNHBNNNHHBNNHTHNHNBNBNNHHBNTNNHBNNNBTHTNNNTNHNNTBNTHNTNTT
TNTBHNHHNHTNTBNNNBHHNNHTTNNHNNNNHHNBTNHNNHTTTNHNNTNNNTTNNHNNBHNNNNNTNHNHHTHBBHBNTNHNNTHTTHNNNHNNNNTN
NTTNHTTHTNTHHNHNNNTNNNNBNTHNNNNNTHNHNNNNNNTTNNNTNNBBNNHNTNNNHNTNNNNNNTBTTNNHBBNBNNTHNNNNTNBHTHNNNNBH
NHHBNHHNTHNHNNHNNNNNNNTTTNTNTBTBNNNNTNTNNTNNTNNNNHHHNNTTHHNBHNHTHTHNNHNNTBTTHTHBNNNNNTTNHHHTTBNHBTNN
TTNNNBTBNNNNNNBTTNBTNNHHNHNHHNTTTTTHNBNBNNNNNNNTTNNTNNNHNTHHTNTNHHNNHTNTBTTHBBNNNTNNNHNBHTNTBNNNTHHN
NNHNHHNNHNTNHNNNBHBNHTNTHNNNBNTTNNTHHHHBNNNNBNNNNTNNBNBNHNHTNBTNNNNNTNHTNNBNTNBHTNTNHNNHNNNBNNBNTNNH
