TNNNNNNNHNHHTNHHNTNTNNNNNHNNHTNNTNTHTNHTTNTNNNBNNNHTNHNNBBNHNNTNHNNTTNNNHHTBNHNNNHNNNHTNNTNHNNNHNNHN
TNNHTNBHTNHTTHTNNHNHBHNHNTHNNBNNNHNNTHNNNNNTTHBTHNHNHNHNHNNNTNNNNTHTHHTTNTNBNNTTHNNNHNHHHNHHNTTHTHNH
NHNTTHBNHHTHTBNNNBNHNNNHNNHNNNNNTBNHNHTBNHNNHNTNTHNHTHNNHNTNTTNNNNTBNHHBNTNTNNNNNBTNNTTNHNBNBTHNTHNN
NNNNNNTTNNHNNBNNBNHHNTHHNNTHNHTTTNBHHTTHTNHHNHHTNNBTNBNNTTHBNNHNNBNNNNHTNNNHBTNNHTNHBHBBNHHTHTNNNTHN
NNHNNNNNBNHTNNTNNNNTBNTTBNHNNBTNHNNNBNHNNNHNNTHNHNNNNBBNNNHHNNHNNTTBNTTNNNBNHHHNTHHNNTBHHHNNNBNNNNHH
NTNNNNNNNHTBHBNTNTTBTNNNNNBHNNNNBHNTHNNTTBNHNBTTBNNHHNHBHNNTHNNNHTNNHNNBNNNHTBNNHTNTNNTNNNNBBNNHHNTN
NBHTHNNHTHHHNTBTNTNNNBBTNNTHHHHNHHTNNNNTNHTNNTNNNHNBNNBHHBNNBNHNBTBNTNBTBHBTHTTNNNHTTNHTTNBHHTHNTNNN
HNNNNNTNNNBHBNNNHNNNTNBNNNNTHNHTBTTNHNTBNNNNTTTNHHTNHTTHNBNNNHTHHNTHNNNNNNNHNNNBTNHTHNTHNTNTHNTNHNNT
NNNNHNTNTNNNNNTNTNNNNBHNTHNHTBHHHNHTNBNHTNTNBHNNNNHNTBNNNNNNHNBBNBNHHNHNNNNNHNNBBNHTBNNNTHNNNNNHNNNN
NTNNNBTHNNHNNTNTTNNNNNNBNNNNTBNBBTNTTHNHHHHNNHNNHNNTNNNNNNNTTBHTHHTNNHHBBNNTTBNTNNNHHHNNBNBNTNTHNNBN
BTNNNHNNNTHNNHNTNTNHTNBHNTBTBNNBNNNNNNTNTTNNNNTNNNHNHNNNTHHNNHBBHNNNNNBNTBNNBNNNTBBNBTTNTTNNHNNTTNNT
NHNNNHNBTNNNTTTNNNNNTBTBTHHNTBTNHHTHNNTHNTHNNTNTNNNNTNNNNNTTNNNHBBNTNNHTTNTNHNNTNHNBHNNNTHNBNNBNHNNN
NTTBNTTTNHNHTHHNTNTNNHNNNNHNNTNBNHBTHNTNBTNTNBHHHBNNTTNNBNNTTTNBTNTTNNHBNBNBTNNHNTTHNHNTNNTHTTHNBNNN
NHBTNTHTNNNNNTNNNNTTNBNNHTTTHNTNBHNHNBNBHNNTNNBHNHTNNHTHNTNNBTNTNTHNNHNTHNNNHBNBNNNNTNTTNBNNNNTBTTHN
NNNNTNTTNBNNNTHNNNNNHNNNNNNNNNNNNNTNHNTTNHNBNBHTHHNHTNNTHNHNNHBNNHTTTTNHHHTTNTNTHNHTTHHNNNTNNHBNHNHN
NTNHNNBHTNTNNHNNNTHNNNHHHHNTHTTBHNBNNHTBNNNNNBNNNNNNNNTNTBNBNHNTHNHBNNNNTBNHTNNHTNNNTNTHTNNBNNNHHBTN
NTTNNNTBTBHBHNBNHTNHHTNNNTNHNHNNTNNHTNTNNHHTTNHNHNBTTHNBNNBTNNNNNNNNNTBNNNTNHHTHTNNHHNTTNNNNHHTNNNBN
NHNHHTNNNTHNNHTNNHTNHNNHNNHHTNNHNNNNNBNHHNNNNNHHTNTTTNHNHNNNTHHHNHNNTHNNNNNNNNBNTNNNTNHNBNBBNBTNNHNN
NNTNTNTNNTNTTNHTBBTHNNTNBHHTNNNNHNTTNHTNHNNBNHNHNHNTNNHNTHNTHNHHTHBNNTTHTNNHTNTHTBNTHHTTHNBBNNNNNNNB
BNNTNTNTBTBTBHNHNHNNNTHHHBHNNBNTNNNNNNHTBNTNTTHNNNHHNNNTHBNNBHTNHTTHNTBTTNTTBNNBBBNHNTHNHBHNNNNHNBNT
THNNNNNHNNNTNNNNNNNBNHNNTNHHNNHNTHHNTTNBTNHNBHHHHNTNNHNNNBHNNNNTHNHBNTBTBHTNNBNTHTHTHNNTTNNNNHNNNBNN
NTTHTHBTTNTHHNBHNTNNNTNNNHTNHNHHNBBHNNNHHTNNTBNHHNNNNTHNTNTNTNNNTNTNNNNHHNNNNHBNHTNNNNHNNNNTNNTNNNBN
HTNTNTHNNNNNNNBNNNHNNNBNHTNNNNBNNNNTTNTBNTHNNNNHNNNBTNHBNBHNNNHHTNHNNBTNNNTHNHNNTNBNNHTNNNNTHHTNNHNH
NTTHTTNNNBTNNNHTHNNBNNNTNBNBNTNNNHNTNTBTNNNHHTTNNNHNNNNTHNTNNNTNNBTNHBNBTNTHNHHHNBBNNBBHTNNNBHTHNNTH
HHNNBBNHNHHTNNNHNNBTNNTHBNNNNBTNTTNNNBNTNNHHNTNNNNTNNHNTTNNNHNNHNTTNBNNNNNHNTNNTNNTTHHHNHNTHBTNNNNNN
TNHTNNNTNTBNHNNHNNNNHNTTHNTTNHNHBHNNTNHNNBNNBTNBTHNNNNTHTHNTNNHBNTNTNNNTHTNTTBNTNBNTTNTNNHTTHTNTNHBT
TNHNTNNNNNNNTTNTHNTNNNNNNNBNTNNNNNNHNHHBTHNTBNNTHNNNTHNNHNNNNHNBNTNTNNNNTNNNHHTNNTTTNNNNNHNBHNTNNTNH
NNTTHNNHNNHNTTNNNTNHNNTNNNNBNNHNHBNNNNNNNHHNHNNBHTNNHNHTTTNTHBHBNNNHTHNTNHNHTBBHHNTNTBTNNNNNHNNNNNNN
HTNNTNHNNTNTNHNTHNNHNNHNTTTTBTTHHNBNNNNHTNTHHNHHNHHNNNHNNTTNNHNBNTBNBNTNTNHNNHHBNBHHNHNNHNNNNNHTNNNH
NNTTHNNTNNBNTTTNNNNTTNNHBNTNNNHHNBTNNHNNTNNNBTNNNBNTTHNTNNNNHBNNNTHNNNNHHNTNHHTTHNBNNTNNNNHNHTHNTTNN
HTTHHBNNBNHNNNNNTTNTNNNNNBNNTTTBNNNNHTNNNNNHNBNTTNNHNNTTNNBNHNTHNNTTHHNNNHNBNBNNHBNNNNHHNNNNNTNHNNHN
HNTNNNNNBNHNNBNHNNNNHNTBNTBNTHBNBHTHHNTNNBTBNNHTHHTHNNNTHNTTTHNHNHNBNTNTNNHNHNHHNTHNNTNTNBNHHNNNHNNN
HNBHTTBBTNHNBNBNNHNNNTTBBNNNBNHTTHTBNHNBNHTBNNNNHNHNTTNNNNHBTTHNTTNNNNTNHTNBTTTNTNNNNHNNHNHBHNNNBTNN
NHTHNTBTNNTHBNNBNHNNHBNTNHHHNNNNNNNHTNNHNBTNNBNTTTTNNHHNNNNNNHTNNNHHTHNNBNHTBNHNNHHNNHTHTNBNNTNBNNNN
NTBTTNHTNBNHNHHNTNNNNHNNBNNNNHTBHHNTNTNNNHNNNNBBHBNHNNNNTNNNHNNTNHTNNNHHTNBNNHHHNNTBBNNHNNBHHTNTTNNH
THNNNNNTNBNNBTNNHNNNTHNBNNTNNNNNTBNTTHHTTNHHNNNTTTNNBNTHNNBNNNNNNTNNNNNNNNTTNTNNBNNNBTNBNNNBBNNNTNHN
HNBNTNTNNTHHNNHBTHTNBNHTHNBNHNNHBNNNNNHNBTNHTTNNHNNHBNHNHNNTNNNNBNTHTNHTNNNNNNHNNTTNTTBHHNTNHNNHNHNH
NNNNNHNNNTHNNBHNNTTBHNNNNTNBNBHNNTTTHNTNHNNHHTHHTHHHBNNNNBNNNHNNBNNNNHNNNTNNTTTNNBNHNNHTNHNTTHNNHNTB
NNTNNNBNTBHBHTNTNNNTTNTHNNNHTNTTTNHHHHNNNNNBNNNHNTHNHHTHNBTNNTTHNNNBBTNNHNHNBNNBTNTNBNNNNNNNBBNNBHTN
BNNNNHHNHNHHTNNNNNNNTTNNNNNHNBNBNNHHHNHNNNNTNBNTBHNTNNNTHNNTBTHNHNHTHHHBBTNTTNNBNTBHNTNBHTTHTNTTNNTB
NNNBNBNNBNNHBBTNHTNNNBNNTTHNNHNNHHNNHHHNNBNNHTNNBNNTNNTTNNNNNNTHNTBTBHTNHTNHTNBBTTTTNNNHTNNNBHNTNTHN
NHHNNTHTNNBNNNNBHTNNNNNNNNTHNTTTNHBNTNHBTNNNNHNNNNHBNNHNHNTTNTNNNTBTHHNNNHNHTTTHTNNNNHNNTNHBHNTNTHTB
BHNNTNTNHHHNHNTNTNNNTHNHNTNBNNTHTHTTTBNTNHNHNNNHTHTHBHTHNBNHHNTBHNNTNNNNNNNNNNNNBNTNHNNTBTNNTNTHNNNH
NNNHTNTNTTHNTTNBTNHNHNNNHTNNNBNHHHNNTNNNNNNBBHTNNNNNTTNBNHTNHNNNHHHNBNTHNHNHNHTNTHTNNHNNHNNHNNNNHHBN
TNNNNHNNHHTNHTTNNNNHNNHNHNHNNNNNHTNTHNHNNNBHNNBHNNNNHNTBNNNNNNNNNHNHHNNHNNNNNHNNHHHNNHTNNNNNNHNNNNHB
NNTTNNNHHTNTHNNNNHNNNNTTNHBNNNNBTTHNBTNHNNNHTNTTNNBNNHTNTTHBBNHNHHBNNTHNTNHNNBHTHNHTHNNNTHHNBBTHNNBH
NHHNNNTNNNHNNNNNTNNBNNTTHTNHNTNHNHHNNTNNTTNHNTNTNHTBNNTBNNTBNHHTNHHTBNTTNTHTNHNNHNNNHBNHBHNBHHNBHTHN
NNBNTNNHNNTNTBNNNTNBTHHBNBNHNNNNNNHNTNBNNTNHBTBBNBNTNBNBHNHBTNNHBNHTNHHNNNHBNNHTHNTHTBHTNNTHNBHTNNTN
NNTNHHHNBNHTNHTHBTNNNHTNNNNTHNTNTBNNNNNHBNNTTTNNNNNNNNHBTNNNNHNBHTTHTHNBHTHNBTNTNNNNNHNTNBNNTTNTNNNH
BHNNNHTNNNNNTNNHHHNNNBTHTBNTHTNHNBBNNNNNNNNHTNBNTNNNHNHTTNBTNNTBBHHHBHNNNTTNHNBTNNHNNBBNBTNNNTNBTTTT
HNNTNNNNHNNNTBNNNTNNNBNBHNHNNTNNHTNBNTNHNNNTHTTHNHHNNTHNHNNNNTNNNTNNTNNTTNHNNTTTBTTBTNHHBNHNNTTTTNNT
THTTTNHHTNNNHNNNNNNTNTNNNBNTHHNTNTTNHHNHTTHHNHTNTNHNTHNTNNNNTNNNTTBNBNNNNTTBTNTNNNNBNNHNHHNBNNHTBNHH
THNNTNHBTNNNNBHBHNNNHNBBBNHTBNNHTHNHNTNNNNTNBNNBTTHNTNBHNNNNHBNHBTNTNNNHTNBBNHNHHTNNNHNNNHNNNHNNHNHN
TNNTHTNNNBTNNNTHBNNHHHNNHTHNNTNHBBHTBNTTBTNNNNBNNBTNNNNTHNHNTNNBTNNNTTTNTNHHNBHHHNTBNTNHNTNTNNNHNNNN
NTBTTBNHNBNHNNNNHTNHNHNHTNTTNNNHTNBTNNNNNBNNNTHNHBNNNTBBTTNNTTHNNNTTBHNNNTHNTTNNNNNBNBNNNNTHHHTHTNHN
NNNTNNTNNTNNTNNHTHNNNNNNTNNNNTTNNNNNNTBHTNNNHHNTNHNHNHBBHHNNNNHBBNNBNHTHNTTTHHNNNNHNNBHBHNTNNNNHNBNT
TNNNTNTNNHHHNNTNHTNNNTBBNNTNNTNNHHTNTNNNNHBNNTTNTNNTTNHNTTTBNNNHNNNNNHHTNNBNNNNNBBTNNNTNNHNNTTNNBHTN
TNNNNNHNHHNNTNNBTHBTNTNHNTNTNNNNNNTNNTHNTNTNNNBBTNTNHHNBTTTHNHNNHHNTNHBTHNHNNNNBTNNHNHBHHNHNBNNNNHNN
NBTNHTNTNTTNNTTNNNNTTBHNHNTTNNNNTHNNNHNNTNNHNHNTNNHNNBTNNHBNBTHHHBHBTHBHNTNNNHHNTNNNTNHNNHNNTNNNHNBT
NNNHHBNNNTNNHNTTBTTNBTHTNNNTNTNTHTNTTNNNNNNNBNNNHBTHNNTTTTNNNTHHNBHBHNNNNNNHBTNNNNNNBNNNNNHBNNNNNNNT
NTNNNBNNNTHNNNHTHNHHNNHNHNNNTNNNNNNNNHNNNNNNTHNNHTBHTNBNNNNNNTBTTNHNNTBBNNHHNTTNTBNNNNTHNNHBTNNNHHBN
TNNNHHBNHNTBNBTBNNNHHNHTNHNNBNNNHHTTTTNHNHNNNNNNTTNNHBNBTHBHNTNNHTTNHTHHTTNNNBNTNHNNTNNHHTTTHTNNBNHN
NTBNNNHNBBNNNTBNHNHNNTBTNBTTNHNHNHHNHHBHNHBNHTNHNNHTNNNNBTBTNNNNNHTHBBHNTHBHTTNHBHNHNTHHNBHNNNNNNNTH
NNNNTTHTNNNHTNNNNBNHHHNNNNHHNHNNNTHNNHNHTNNBNHTTTNNTHNHBTTNHNTNNHTTHHNHHNHNBNTNBTNNNNHTNNTTBNNTBHNNT
BHHNTHHHNNNNBHHHNNNBHNHTNNNNNNNNHNHNNNNNNNTTTNHNTHNBNHTNNTBNBNNNTHHNNNTNNTNHNNTNNNNHNTHHTNNHTNTNNHHN
BTTTNNHTBTTNTTNNTHNTNBNNHBTTHNTTNNHHHNNNNBNHNHHNNHHHNNNNNBHHNNNNHHNBNTNNNBHTTTNTTHHNNNNNNHBTNHNNBHNN
TNTNHBNNHBTTNTNNNHBNHNNHHHNBNNNHHNNNNBNTNHNNTNNBNNNNTNHNTNNNNNNNBHHNHHNHNNNBNHNHBTBNNBHTNHTBNNTBNTNN
NNNNNTHNTNNBNNNBTHNBBTNBNNNNHTTNNNTNNNNNNTNBTHNNNNHNHNNHNTBHNBNTTNTNNNHHNNTTNHNNHHTTHNHHHTHTNNTNTTTN
TBBHHHBHTTHHNBNTHBHHTNTHBBBNTTBNNNNTHHBNBNNTTNNTNHNTTHNNNNNNBBHTNNTNNTNNHTNNBTNBNTTTNNNNNTTHHBTBTHHN
NNBTBNNNNNNNNTTNTNHHTNNTHNNNNNNTBNNHBNBNHNTNNHNHTTTTBNTNNBNTNTTHBHTHNNNNNBNTTNNTNTNTNNTBHNBNHHHNHNNH
NNNNNHHNNBTNNNTTNNNHBBHBBNNNNHBNNNNTNBTNNTBTNTHNNNNTNNNNHHBNTHHNTNNNNHTTNHHHNHNNBHNNNTNHNNHHBTNNHHTN
BNHHTHTNNHHHNBHHHHNNTNHNNNTNTNHNNNNHNNNTNHTTNNHNNBNHHNNNNHTTTNNNHTBNTNHBHHTTTHBTHNNNNNTBBHNNTNTNBBTN
NHNNNNNNNNHBHNTHHHHNNNNBTNHTNTTHTNNTBNNNNHNNNHHNNNBHNNNHTHNNHNNTHHHNNTNTNNTTTNBNHNNTHNNNNNBNTNNTTHTH
HTHNNNBNNNNHNNNTTHBNTNNNHTNNBNNNBTNNTNNBNNNHNTNHHNNNHTTHNTNNBHTHTBTHHNTTTTNTTNNTHNNHHNNTNTNTTHTNHHNN
NNHTNHBTNNHBTBTNNTBTTTTNHTTNTTNNTNNHTHHHBNNNBNTNHNTNHNBHNHNNNNTTNTNNHHHNNNNNNNNNNBNHNNHHHBTHHNNTBNNT
NNNNNBBHNTHNNHTNNTTNHBHBHNHHNHNNTNHNTNNNTNNBHNHNNTNNNNNNTTNTHNNNHNHNNHNNNNNHNNNHNHBHHHTNNTNBTBHNBNTT
NNNBTNTNNNNTNNHNNNTBNTNNNNTNNNNNBBNBBNNBNTNBTNNNNNHNHHNTHHNNNTTNNNNHHBNBNNNNNHNTTNNHTBTBNNBTHNNHNNHN
BTNNBNNNHNNNNTNNNNBNNNTTNHTNNNNNNNTHNNNBHNTHBNBNTNNHBNNNNTNTNHTNNNNHBNNBBHNBBNTHNTHNTHHNBNNNNNHTNBNN
NNNNNNNTNTTNNHNBNNTNHNHNTNNNNBTHTNTTHNTNTTNHTNNNTHTBBHTNNNBHTBNNNHTBHHNNTHNHNNNBNNBTNTNNTNHNNNNNNNBH
NNNNHNNNBNBTHNTBTNBTNTHBNNNNNNNBNTTTNNHNNBTNHBNHHNHHNNNNBHNHHHBNBNNHTNHNNNBNNNNHNNNNTBTNHNNHHNHNTNTN
TNHNBHHNNHBHBHTNNHNTNBTBBBNTNNNNNNHNBHNNHHNNNNHNNHTNHNNNNNNNNTNTNTNNNTNHTNNHNNHTBNTBBTNNNBBHNNNNNHBB
NTHNNNNTHTTNTNNNTNHNTNHNNTNNHBHBBNBNNTTNNHNTTNBTTNNHTNTNNBNHNNBTNHNHNTNNTHTNNTNTHNNNNNHNHHNNTTNNTNHH
NBNTBNNNHTNNNHNTNHTHNNNHTHHTNBTTHNNTTNTTNNHBTNNNBTTNTNNNNBNTNNHNHNHHNBNNNBNTNNTTNBHTNHHHNTTHBNHHNNTN
HNBTNNNNBHNTNNTNHNHNHTNBBNNNHBTTNBNNNNNHHHHHNHTNNBNNTTBTNTTNHNBHHNBNNNNTHNBBNNBNTTNNHTHHNNTHHTNNTTHN
NNNHNNNNBHNTNNNHHHNNHNNHNNNTNHNNBNNTNBNTBNBNNHBNNNTTBNNBTHNHHNNBNNNNNBTHBBTHNHNTHBNNBHHTHNTNTNNNTNTH
NHTHHNTBNNNNNHNNNNNHNHHNBNTNNTNTNNHHNHNTNNNNHBHHNTHTHNNNNNNNBNHTTHHNNTHNHNHHBNBNHNNHNNNNNNNHBTNHBNNT
HTNTNTBBNTNNHTNNTTNNTTNHNBHBBHNTNNNNNBHNNTBTNBNBNNTNNBNNNNTNHBNNHNNTNTTHNNNNTBHHHTTNNBNNHHHHNTHNHNBN
NNNTHNHNBNBNNNNBTNNHNNNNNNHNTHNNBTNHTHTTBNHBNNTNBTHNNTHTNHNNHNNNHHNNBBNHNNNHNNBNNNNNNHNHNNBHTNNTBNHN
NNHNTHTHHNTBHNTTNHHTTHTTNNNNTNBTTNNBHNBHNNNHTTNHNHNHTHNNTNTNNTNTNHHHTNTTHNTNNNHHNHNBNBHHNHTTTTNBTHNT
NNNNHNNTHNNNNHNTNNNHTNNNHTNHTNHTNNNHHHBNNNNNTNHNHNHNTHBNHNNNHNNNHNHNHNHBBNTHTTBNTTNHNNNHBTNTNHTNNTBN
HHHTNTHNTNTNHNTHTNHHNBTTNHHNNNHNNHTNTNTNNHNHNHNHNNTNNNBNTNNNNNTHNHNTNNTNBHNBTTNTNBNTNNNNNNHTBBNNHTHN
NNNTNHTBNNTHHNNHNTTHNNTNNHBNNTTNNHNHNHHNNHNHHHNBNHTNNNNHNNNHTHNNNBNHHNTHTHTNNNTTNNTHNNNNNTBNNNNTTBTT
NHTNNNNNBNTNNTNTBNHNNNNNBNNTNNTBBBNNNNNTNHNNNNNNNHNBNTTNTHTTHNNNHHTHHHHTTNHNNHHTHTNNTTNBBNBTNHNNNNHT
HHBTTNNTTNNTNNTNTTBNNHNHHNNBHNNNTNNNHNNNTNBNHBNNNNHTHTTNHTNNBNBTTNNNNNNNNNTHNTNNBNTTHTNNNNHNNHTTHNNT
NNHNNNNHTTNTHNBTNHNNTTBBNNTNHNNNNNTHNNTNNTNTNTBHBTNHTNNTHNNTHBHNNBNNBHHBNNHNNNNHNHNNNTNNNTNHHNTBNNTN
TNHNNNTNBNNNTHTNNHNNNNHTNTNNBNHNNBNNTTNNBTNHNHNNTNNNBHBTNNTNNNNNHNHNNNNNHHNBHBNNTHNNNTNBTHNNTHHNTNNT
NNHHNNNNHNTBHTHHBNNNNNNHHNHNNNTNHHNNNNNNNTBBBTNHBNBNNNNTTNNNTBNNHNTBTNBTTNTHNBTNBNNNNNNBNNNTBTNNTNNN
NNTNBTHNTBNNNTNNNNNNBNNNTHHNNNHNTHHHHBNNBTBNTNNHTBTNTNNTTNNHNNNHNTHTHNNHBNBHNHHNHHNTHTHHNNNNHBNNNTTN
NNNTNNNNHHHBHNHNHNNNNNNHHNNHHHNNNTHNTHNTNTNBNNHTTTNNHNNNHNTNNNNNBNNNBTNTTHNNNTBTNTNNHNTNBNTNNNNNTBNH
HHNBNTHNHTNTTNHNNBHNBNTNBNTNTNNNNTNNTHTTHTTTHHHNNNTNNTTHBNNNNNNNNNTHNNTNNBNNBBNNNNNTTTTNBNBTNHTTNNNT
