3112001013311301321111111113101121222111023131213131110312211021013121211121130110311131313111113211
3221121111122321131302333131121101311002133113111311320113001130112033301010312112011211111111120311
1101231101320110113211321001112113102121112102110301101333101222213113131211121012202321201101011332
3301211121233110113113221113121311112312211102111013111311131121211113130111122321113120223100120323
3211031303213322130111111121211211031111110331122222221201111122131120103102021012131121103122311112
1231013211221101213111221113311122113110113113113312103133311121203233123121111110313130212122122111
1220133301312120013311331131211111011131312122111112313031131113111101333221212111101122213321112112
3130111112001111013323232321101121113133020221322210111331112231330113321031111101131121112102110211
1113333231113113033321321111131111011111022100122112232313121113113111013113213003001111011201322221
0012111132213112111112031231012331131311111030003121111101331201231011132111111130112121133223131313
1101112313012331201111113121230220131111212230130212312022131210133231121111111231331331101311031223
1121121112101113121113111201132112111110111102311202123303112211331321233011311221111113011221310231
1213132110122321101231012132122131102310312111310112231321101323133012112133003101231123111210211121
1220312211111231113111310113232222102113211111112312113321021021111311322110133332131110111113123132
1211111111131311033111133311113131112111113121311011031312133033110121202121111133221131110121211313
1111211121121123112211310201113030011003310311201311232101321311001011101013111012311111011331221033
3131221322111231111102111202123332103321130132111321111101313120211131211111122111110112121131111112
3112110331312111331123012120311203212111221312121330313112301110112211111301320111103013320311102111
1202111203012111023101111122103000133131332131311123131131001310121101330203132110110111131111103221
3111311311022112111133211313331123310111211110111132101210023012311112102213111211131021212132130133
3111123132032322231231111120230331111312111121123022111212101231131111311112112213121111112121111113
2123331221123102110211323121113331111231011131111111222313130010112111321111311213131112211212011310
3131302211012123113011121311101111111211322131111100101113022211331110131211113113110031313211333132
1010211331212222102323121132133112212131013113223121211213212102113110011111112103323011122112111321
1113131222313221211131220211103111132221033331110311333003112023131323131332113011111212122031311012
1111330331201121111121111121111223112321213022122112111102133311012122221131211122212113210131021111
2111112123011111210210231211321221223120132112110021122111112132233112111111111211111213021110130311
3220202211113022311113121211021111111111122111120113301202231121111213311211112300111213033101101111
3213302012111321131222111103230102211111111110013130133301311121321121301312233331211101201101031113
0331221031111101112231111101013133131113021312330210313123131111012311131301321131101311131123321110
3112032311230130103120200122112300211213121131111212010101120113022002131101331111212131121012232022
1101200113212322120022333130201123210010323111122112111131123302232103001131313132102211101131113211
0333130330112331111112231021111212113311321121323131013212210111112212212112111102112121302221111302
2011122312110210003121223331111111121313111122213123310103301210110011321203331311120111113311013133
1223121311331211112111112133311111211120122111102121313121131011232111013112311331111131101013110133
1113311121313101201011312021231131133320211213131331111020313110111311330122211133111233013213111001
3210313131132131221332220031312210101211111031022310111013212212313132032112321223210012131121311111
3021101122011121321022121221211131131321111122111131131201303131331310013111112121211111231101213233
0131021112130112112321121113320132303131012331121113110331113100111111113331221111310101130101311111
1122331220221021132311110213112331311313111332321313130111313221113131131202311122213231113112321211
2112213031133110133231212103311311011010132111111113131103313132023321133023111312101311111122111331
1313122123131122312112111311131112200021112102233033101112223112313112330322211131210122020122211012
1232201121023111011111101100231113011121122213310111211311201113221130121223311121120312111211313132
3111313311013110132113111322121032112031102211310322011213310110223010110132111103011133111121121132
1111121211111110111330210133111103021131113303132130121113211332113113101031111221112113113010110110
1131311130123011112123313131232332121111113101211110003201311131121110111111320121111301013233213113
3011032230121121111111311311123323010213311311221232321213211113132011112111313121321111102111132101
2113101131101200211121111232110330111331333111131303211211311111330213111311131311033112321111101213
1003131003112111321312311101132113112112220103111112121111121111121111132111333012111233332313331310
1221123111130122313320111210131132121312022310112111213132113111122320321111111310111110313211033230
2122120112201321012123310313111112213132113221311133311133100111101110120100133311121113112111311221
2311131111131102111123210321111111231333133311222212122213100221013213311113233111231232122221110121
1311112231212101111313101121110311313132231011322101113113103233111011221132121231010122112121111132
1312030220031110011333131013321331323113011121120132221131310011110332012001331111122203110111111223
2311020212210111113111123110112311111311111122033311310112232103012111200323111121121312331131123111
2231021131123113111112132233213122311133301232013331311131131102110111212330111031321313311021123212
0111111111213310131112111131231011012133223313112112130310111313122331131113102110020201133221111223
1321013330201302210310211311102111111101110111113311302211111313331032131131111113131311212111223123
1113112222331133311331111032123112131333111333210111111101301111210111221013213113112112201311011110
1131131111211112021113111211111311113113212320113121311211100202313113110113111313111113112112323132
3111111322011331213330112111131131213031321111233111031211022201312201113131312112122131331212131121
3133113130100331111230011212312223312112102031132121221312121000112231121121311312131111310113132312
1332112111111121311311112120310311311313213321233111211113131311121212030231111111211121110112213201
3313131101210113301131313201021111230020111121111131132310113132231232111201322132223211122101312212
1213113211133110113112311333133213131330031313111311112131211112313310211233121231331102211230203112
1111331331321121311023212111220112321232323113331133230121133011312121020101022331121113111311011011
2211311102102111223313113213123232231112213111100113313113212011211123200211112121111112121231220321
2202231322001332211111101133111020113102310133121312112101211111132331113112313310013132111101122112
3113301313101132113223133122112312022211122110122112132032213331113111311303101110311111311111213310
3231131112131211323111211112113111111321321211111113023313313131322131103121211112111303111111111233
2212023112021213133112111111111121002111112011021222231020022231113321110210212220112112212113213010
1112211111111022131123012213131212321110211111012333123112121123131112113201111103221131232211111111
3131111232111003312112312011131210111111113132311111112131132011223111011211031201111312330231103131
1111110111013111112113102203323121313110111211111113111210313111212111203111120113121113112133313013
0130221132121131313121110111111111200212322112111221112112213111121333231111022213132131301111131213
1232233111111221111331121332131031113111233323212111133311113011113333313332211211121100320231112113
1211131021131320112311111002111013110121121111210312311111313332221111211013112331131211121002331233
3011111322102301301131321101110021132011201331230103313211221311111112011113111320311131111113211311
1231131221313231111313332012113321112112101122013110311130202013122131312131213113121011333101313312
1112133130111032033121131110121310213011123313113201333311112113130121121130013221210111111131321112
1111211113101133111313332111123111023112121122230111330110131112121112321121201101100131031121112201
2221113111131113122111102111131212033133021113112232303311311301311231111331113103133131113231221202
1212211131112033111112332212323111113231231110311312332232131323013113223111020111123231121121111110
3111113300132112211300302111110202133112211203311211113321121231112123211130303130031133131311321311
0011331231321312110310112312131121123103123330121311233122110213112211111312111130111131212210311101
3230123121322333122221031312231130131111021133201013121211111111332102212020310111211312113110112111
3113323121333131211131212212011101111121031321211100110211110313001121133101213311313320132031130213
1221321111332121101013321003032212022131103132211121112101211311021112130311201213113131131101131332
1133212111213221323301211231111111111113131100131111121123201131311110222231210121131012103312211211
3111310110111033211111301113310123212131111021111110133311233123132211331231222111120111100231131211
2111313113222223233331010212331031131113311131111111110112131111333332301111112332312111311120301110
2211111311131113101131131113111202113122111323332111111132212101313131131111330321111121121311121231
2221121031321111131223231111213130232111011130320321001113113111311122112211311111112211301110201112
3211311112123230211111033322111123131111223131102111113123211031101010101112001213311121121121032112
2111203212313010322311112113131211131313323122233113312211112131311011211311131111012111021112110102
1231111311112111202132021330222221021113213133213132311130223311112111233201121131333211231111011121
1211212213110131212103111113111111211131121112121101220012102103233113221132101110112332231220111311
3121111031331123032131321111322233133123123301132031313111131211232112111113130112232213111231211131
2111131111131110212202121210231133111211131021111132111321313131310112301221311311313113213121211312
3121311131111111221310111113312133302213121111011011111131101301111111331112111131132231221113330111
