TTTTTNNHTTNHNNNHHTTNHNNHBNTHNHNTNHNNNHNBHNHNNNNNNTNBNNNTNNTBHNHHTNNNNNNBBNNHNTHNTNNHTNBHHNNNNNNNHNTN
BHNNTNBNNNNNBNHHBNNNTNBBTNNNBTNNNNNNHTHNBNNTTNTNHBTNHTHNNTBNBBTHTHNTNNTNNNTTHNHHBNNNNHNHBHTHHHHNBHNN
HHNBNNHNTNBBHNHNTHHHTNBNHTNTNBHHNNNHNTNNHTNTHTTTTBBNHTBHTNNNBNHNNNNNTBHNNBNNBBNTNNTNBNHNHNTNBHNBNHHB
TNNTNHTHTNNNTTBTHHHNNHNNBTNNBNNBHNHBNNNBNBNTNHHHNNBNNNHTTTHNNHNNTTTHTHTBNNBNNNNTNNNNTNBNHHTNNTHNNHHB
HTHNNNNNNHNTHTHHBHNNBNTTNNHHTHNBHTHHHNHNNNBHNNHBNTNNTHNHHNTHHNNBNHNBHHNNTNBBNTBTHNNTTNNHNNTTBTBBNNNN
HTNNTNTNNNNHNNNNHNBNBNHTNNTNNBBNHNHNTNNTHNNHNNTNNTNNNHNTNNBTTNTNHBNHNNNBNTBNNNHNTBNNBNNHTHNNNTNTTNNN
NNBNNHHNNHNNHTHNNNTNNNHNNTNHNTHNNNNNHHHNHHNHHNNTHNNNNNHNTTNBTHNHNNHNBNNNNTNTTNNNNNNNNNTNNNBHNNBNHNNN
TBTNNHNNTHHNNNHNNNNNNTNHNNHTNBHNHNHHNNNNNTNNTNHHNBNTTBNTNHHHNNBNTBNNTTNNHTTNHNNNHTNNTHTTNNNHBNNBNBNN
NBNNNNNNTNNTHNNNBBBHTNNNNHHHHNNHNBNNNNHNNTHHNHTNHHNNNTHBBNNNHBBNHTHNBTNNNNHHNNNNNHNTTNHTBNNHNHHBNNNN
NNNNHNHNHNHHNNNNNNNTBNTNNNBNNHHNHHNHNTNTNTNNNTHNNNNNBBNTHHNTHNHNNNNBNTNHNNNTNBNNNNNHNHNNBBHNNBBTBNTH
HTNNHNTNNNTHHTNNNNHNHHNTTNNNNHHTNNBHNHNHNHTTNNBNNNBNNTHHHTHNNHHHNTNHNHNNNHNNNTNNNTNHNTHNNNNHBHNHHNTH
NNNTTNNBNNTNBTNNTNNNTTNNNHHNTNNTHNTTNHBNBNNNTHNHNNTBTTBNNNTNNNNNNTBBNNNNTBBNHNNNNHNNTNNHNHTNHNNTHHBN
NNTNNNBNTNNNNHNHHBHNBNTNNHNTTHNNNBHHNNBHTHTNNNHNNBTHHNNNNTNHNNNNNHTTNNTTNNHTHHTTNTNTNHTNHNBNTBTTTTHN
NBNHNTNNNNTNHHTTHNNNBHTNNBBNNBNTNNNNTNNNNNNNTNNBNNNNNNTHNHNNHNBNNBNTNTNBHTBNHBTTTTHNHNNHNBNHTTNNTHNT
HNNBNTHTNNNTNHTNNTTNNNNHHHTNTTNTNNNHHNNNTNTNNHNNNNHNNNNNNBNTNHHTNNTBBTHBHNHHNNNTHHNTNTNHNTNNHHNBBNNN
BNNTNTTBNHNTHTNHNNNHTNNTNHHNNHNNBNNNTNNTNTNNNTTHBNNNBNTBBNTTNNNHHNTBNTNNBNTNNNHNHHTTNTNNBNNNTNNHNTTT
TNNBTNTNNNNNNNTNNNBNBNTTNNHHNTHHHBTNNNHBHBNHNNTTTTBNNHHNNBNTBNNBNTNTTBNNHBTBNNTNNNNNTNTNTBNTTNNTNNTN
BNBNNNBNHTHHHTHTNNNNNTNTHTTNHNBNNNNTHHTHBBNNNNNHNNNHNHNTBHNNNBTNNBHHHNNTNTNNNTNNHNNHNHTTNBHNNTNNNTNN
HHTHNTNTHNNNNNBNHBBTNNHHTBTTBNNNNNNNBBNBNTTTNNNNTNBHNNTTBNHNHNNHHNNHNNNTNBHTHHHNTNNNTNNHTHNNNTBNNBTN
NBHBNTNNBNTTHBNTNHNBNHBNTNBTNTNTNHHNTNTNNNHHBBNNHNBBBNBTNNTTNNNTNNTHNNNNBNBTNHNNNHNTNNNNHBHNNNHNNNBH
NNHTNNNTNHBTHHNNBNNNHHHNHHNTNTBBHNNNHTNNBBNHNNNNNNBTNHNBNTTHNTNNTTNHNBNNTNNNNNNHHBHBTTTNNNNHNBHNTTTN
HNNNNTBNNHNNNNNTHTHBNNNHHNNTNTTBNNNTNTNHTNNHBHHNTHNNTNNNNTBNNTNTHHNHHTNNHTNNBHNHHNHNNNNTHHNNNBHHTBNN
BHHNTHBNTTTNNHNNNHNNTHNNNNBNTNTTNNNTNHNHNTNTTNHBNNNNHNNNNNBHNTBTNTNNNHTBNHBTNBNBNNTNNTNHHBHNHNHNNBNN
BNNTHNNNTNNHBTTNNNHNNTHBBBBTTTTBNHNHNHNNTTNNNNHHTNNHNBTHNTTTHNNNNNTNHNNNNBBNHNNNNNNHHNTNBHTBHBNNHNTN
NHNNBNNBTNNHNHNNHBNNNNNNNTNTNNBNTNBTNNNNNTHHNNTNHHTBNHHTHTHNTTNTTNBTBNNHBHTNHTTHNNNNHNHNTTNTNNTHNHTN
TNNNNNNNNNNBTNNNNTNTHTNTBBTTTNNNNTNNNTNNNNTHNNHTTNNNNTNTNBNNHNTBTHHTTNHNNNTNTNTTBNHNTNNBHBNHNTNNNHHT
NNNHHNHHTNNBBTNNNNHTHTNNBNNNNNHHNTBNTHNNHTTHNNTNNNHTNNNTHNHHTBNHHHHNTNTHHNNHTHBBHTTNBNNHNNTNTNNBHHHN
NNBNHHNNNNNTTNHHTTHHBNNNNHHNTNBNTNBNNTNHNTTNTNHNNNNNNHHNNHTTTNNHNHHNTTNBHNNNBNNNTHNNHHHHHNNHTNHNNTNN
HHNNTHHTTNBNNNTTBNBHTBNTNNTTHTNNBNNNHHNNTHNNBHHTHTTTHNNHNNNNHNNBHNHTNNHNNBBNTNTNNBHBBTHHHTNHNHNNBTNN
NHNNTNNNBNHBNNTTTNTHNNBNHNBNHHNNHNBBTHNTNHBNNNTBNTBHNNNHNNNTNTTTBNNBTNNNTNTNHNHTNBTNNTNTNNTTNBNTNNNN
TNNTHNNNHBTHHNNNHNTTHHNHNTNHHNBNTHTNNNHNNTHNBTNNNNNNHNNHTHHNBNTHHNBNNHNBHNNNHTHBNNTTHNNNTTNNHHNTNTHN
NHBNNNHNNNNTTBNTBNNNNTNBTBTNNNNNHNBHNHBNHNTNNNHNTNHBTNNNNTNTBHNTTNTHNTTTNBHHNNBHNNHNNNTNBNBNNHHBBNTT
NNNBHBTBBTNHBTNNNBNNNBHBNBHNNNTHNHTHNBHTBNTNNNHNTBNNNNBNNHHNTNNHTHNHNNTNHNBNHNNBNNBNNNNTNNTNNHNNBNHT
HNNHHNHTNBTBTNTNNTNHTNTTHNTNNTHHHNTNNNNNBNNNNNTNNHNTTTBBHHNNHNHTHNNNNNTNNBBHHNNHBNTNHTTHNNNNNNBTNNTB
HNNNBTTNHHNNNTHBNHNTHTHNTNNHHTHTNHTBTNNHNTHHNHTNNNNNNNNBNHTTBNNTNBTTNNHTHNNBNBTNBNNNBHNTTNBHNHHTBNHB
HNTNNHNNNTNNNTNNHTHNNNTBNHTTNHNNNNBNHNHNTTNNHNTTNNNHNNNBHNNNHTNNHNHHHNHNHTTNNNHNHNNNNNNBNTNHNBNTNNBN
NTNHHNNHTNNHNNHTNNBNNHNNNHNNNNNNNHTHNNNHNBBHHNBNHNBNNTNTNBNTNNBTNNBTHNHNBNBHTNHTTTHTNNNNNTTNNHNNBNNB
NHNBHBNNNNHNHNNNTHNNNHNTHNNTBHNBHTNNNNNNNNNNNNHNNBTNNNNNHTHHNNNHNHTNTNNTNNNTNHNBBTNNNNHNHTHNNTNNTNTT
TTNTNNNTHNBNHTNTNHNNTNNBNHNHNTTHNBBBNBNNNTNHTNNNHHHNHHNHHNNNTBHNNTTTTHTTNTNHTTBBNHTTNNBTNNNBNNNNHNNN
HHNHNNNNHNNTNNHNTTTBTNTNNNNNTNNTTNNNHNNNNNTNNHNTTTNNNBTNBBNBNTNHNNHNTTHNTNNHBHBNHHHTHNNHNNHTHHNNBTNN
NNNNNTHNTBTTNNNHNNNNTHTNBNTNHTNTNTNNTNHNBNTNHTNNHHNNTNHNHTHHNBNTBNHHNNTNTHHNTTNHNTNNTTHHNHTTNNNNNHBB
HTNBNHBBNTNTTNTNNHHNHNNNNNTTNNTBNHTNTHNNHTNNTTNHHNNNNHNHNNTBNHHTTNTNNHNTHTTNTNHNNTTNTNNTNNTNHHNHNNNN
NNNTNHTNTHBNTNTTNNNNBNHNHNHTNNBHNNBNHHTNNNNNHTHHTHNNNNTHHBTTTNTTTTNTNNBNTHNNHTTBNNNTNNNHNNNTBNNNNNNN
NNNTNTHTHTNNNNNNNNNNNNHNTHNBNNTNTHNNNTNNTHNNTNNNNHNNNNHNTNNHNHNHNNNBNHNHTTHTNHHTNHNHHNNNNHHNTBNNTNNH
TNNNNNNNNNBNTHNNNNBHNTNNHNNNHNNNNNHNNTHNNNNTNNNNNNNNBTHHNHTHNHTTTNBBTNNBNNNNTTTNNTNTHTBHBBHNNBHNNHNB
TNTHTNHNNHTNHNNHTTNHTHNNNHTHNTTNNNTTBHBNHBNTNTNBTNNNNHBHHTNNHNNNNNTHHTNNNTTNHBNNBNHNHNTBTNNTHNTHNHHT
BNTBTBHTNTNNHNTHNTTHNNTNNTNHBNNNTNNHNNNTTHHNBHNNNNBNNNNTHNTTNNNNTNBHNNHNHTNHBNNTHNNHNHNNTNTHTNHHNNNN
TNNHNNNNNBHTNTNNNTNNTBNNBNNTTNHNNNHHTBNNNNBNNTHHNBHTTNHNTNHTTNNTNHNNNNHBNHBNNBTBNHTTTNBHNHBHNNNNNNTN
NNTNTTNNNNNNNHNHNTHNNBBHNHHNNNNNTNHTHNBHHTNTNTHTHHBTHNNHNTNNNNTNHHHTNNHNTNBNNTNHTHNTHHBNHTNTNNHTNNNN
NBTNNHHTHTNTNTNNTTNHNHBTNTNNNNNNBNTNNHNHNNBNNNHNHHTNNNTNNNHTHHTNNTHHNNBTTNNTHTTNHNNTNHNNTNBHBNNNNNBT
BHNNTTHNTNNNTNNNNNNTNNHNTNNNNNNNNNTTNNNNTHTHHTHNTBNNNNNBNNTNTHBNTNNNNNNNHNHHHTHTNNHHNNTNNNTBHNNNNHNN
TNNTHNHTTNHHNTTHTTNNHBNNNNNTHHNHHNNNHTBTTHTNNNHNHNNNNTNNNNNNNNNTNBNTNNBTNHHNTHHNNHNNTNNNNNHBBHHHBNNN
BNNHNNNHTHNTNHNNNBHHNBNHBNNHBTNTNNHHHNNHNNHNTHHTNHTTHHTTBNNHNNNHBNTHTNTTHNTNNNTNNNTBNHNTTNNNNNNHNBTN
TBTNHHNTNHBHNNBTNBHTNHHNTBNNNNHHNNNNNNHHNNBNHNBNTBNHBBNHNNBTTNBNTHHHNBHHNNHNTHHNNBNBNNHNNNNNNHNHTBHH
BHTBHTTHNHTNNBNNNNNNTTTNNHNNHTHTTNTNNTNNNHNNHNNNBTHNBTTNHNHNNNNTNNNNNHTNNNNHNNNNTBHNTNNHNBHNTNNNTHBT
HHTTNNTNBBNNHHNNTTNHTTNBHNNTTNTNHNTNHNNHNNNBTNBNNNTTNNNTTTNNBBNNTNHNNTHNNNBNTHHNHNTHHBNNHTTNBHNNHBBN
THTTNNHHNTTNNBNNHTNHTNHNNHBNNBNBHNNNTHNTNNTNNNTNNTBHTHNNBBBHNBNNNNNBNNBTHTBHNHNNBNHTNNNNTHNHNNTHTNNN
NHNNNNNBNNNHNNNNNHNNHHHBTNNNNNTNNNBNHTTNNBNNNNTNNTNBBHNHTTNNHNBHNNTTNHHHHNNHNNBHTHBNTNNBHBNTNHNNNTTH
NNNNNNHNTNHNNTNHNHNNNTTTNTNNTTNTNNNNTNNNNHHNNTNTTNTNNTTNTHBHNBHNNNNNNNNNHNBTBNTNNNNTBNNBTNBNBHNTHTBT
NNNNHBHTNTTTNHNTTTNNNHNNNHNBBNBNNHHNNHTTHNBNNNTNNNNBBHNHNTNBNNBNTTTHTNHNHHNNTBNTTNNNNHBTNHNHBTTNNNNB
NBHNNBNTNNNHNHHNTNTNNHHNNNNNHHNNHNHBNHBNNHBNNNTNNHNNNNHNHTNNHNNHHTHNNNNNNTBNHNHNTHHBHNTTTTBNHNNBBNNB
TBHNTTHNNNNTHNNNBNHTTBHNNHTHBBTNNTHBNNTNBNBNHNNTTNTTNBBNNNTNBTHNHHNBTNNNBNHNNTTNTNNNNNNBNNNBNHHTTTTN
NHNBHTTNHHBNNTHTHNNTTTNBHTNNTTNHHNNNNNNNNHHTNNNNNHTHTNNTNHTBBBNTNTNHNTNNTBNNNNHNHHBNNTNNNNBBNHBHNNNH
NNTNNHTBNNHNNTHNNNNNNNNTTNNTTNBTNBHHHNNNNNTNBNNNHBNTBBNHNNBTNNNHHTNNNTTNNNNNTBNNHBHNNNNTHBHNTNTNTNNN
HNNNTHHNNTBHHTNTTNBBNNNNHTNTHBHTBTNNHNNNTHTHNTTTHBHTNNHNTHHHNHNHTHNTTHBNNHNBBNHNNNTHNBNBNBNNNHNHTBHB
NBNBTTNTHTHNNTBHNBNHNNNNHNHBNTNNTHNTNNNNNHBBTHNNNNBNNBNNHNHNHHHHNNTTNHNHNNTHTHHNTNNNNNBNHHNNNTNTNBBN
BNNBTTNNNNNNNHBTNNNNNHNNTNTNNTNNTBTTTHHNNTNNNHTBTNHNNBNTTNNTNNBHTNNNNTBHHNTNBTNNNNTNNTNHNNTTBNNHNBTN
THNNTTHTBNNTNHNNNNNNHNNNNNTNHNNTNHNTHNHBNTTBNNNNTTTTTNTHTTTNTNNHHHNNNHNTTNHBBNNTNTNHNHHNHTBTHHNTHNHB
NHNHNBNNNHNNHNTBHNBBHNHHTBTTTTHHNNHTHTNNHHNHBTTNNNNTNNNHNNNNNHHNNNNNNBNHNNNHNHBTTTTHNNTBNNNNTNNHHNNT
BTHTNNBBNTNNNNBHHBNHBHTBHNNHTNNTHTHBHNHBNTHTNNTNHHNNNNNHTHNNHTNTNNBNNNHNTTTNNNTHHNHNNNNNTTNNTTHNNTTN
HNNHNBHTHTNNHNBBHBTHBHHTHNNTNTNNBTHNHTNNTNHNBHNNHNTTTNHNBNNNBTTNTHBNBNHTTTNNHNNHTNNNTNNBNNTTHNNHTTNB
BNHHTNTHHHBNNTHNTNHHHNBHTHHTHHNNHBNBBNNNNTTTHNBNNNTNTBNHNNNNHTBTTBHTHNNTTHTTTNNNTHHNHHHTNNNHTHNNTNTN
HBTNNTHHHNTNNNTNNNNNNBNTNTBBTNNNNNNNNNNNHNNNNNNNNTHTNNTHNNBNNNHTTNNNHNNNHNHNNNBNNTNNTNTNBBTNHHNHNHNT
BNTNBNBHHNNNNHNHNTHNHBNHHNNTNNTNBBTHNNNHNHNNNNHNNTBBNNHNTNBHHBHHHHTNNNNTNHNNNTBNNNNHNNTTNTHNNNNTHBTN
NNNHNNTHNNHTNHNTNHBNTBNBNNNHTNTHTHNNNBBTTNTNHNNNNTTNHNHNTNHTHNNNNTHTNHHTHNTNNHBTNTNNTTNNTNNNBTNNNNTH
BNTNNNBBNNNNHTBNHHNBTNNTNNNTBNTBNTTNNNNTNTNNTNNNNNNNTNHHHNTNNTTHTNHNTBNHTNNTTTBTTBTNHHHNTTHNHTHNHNHH
THTNNNTNHNNNNNNTNNNNHBNTNNNNNNTNTHHNNNNHNNNNNTHBHHNNNHHNNTHNTNHBNTNHTNNNTHNTTNNNTNNBNNHNBNNHTBHTTHTH
NNTNHTHNHNNTHHNTNBNNHNNHNHHHHNHTHHHTNNNBNTNNHTTNBNNNNTTTBTBNNNTBNTNHNNHNHNHHNNHNTTNNNNBTNNNHNNTNNNHN
NHNHTTTBNNHNNNNNTTHTHHNTHNHBNBTTHNNNNNNTTTNBBHNNTNNNNNNNHNNBHTNBTNNNNNNNNHNNNBNNHTNNTHBNNNNNBNHNTNNT
BBTHNNNHHNHNNNNTNNHNNTNNNHHNBNBNHNHNNNNNNBNNNTNNNTBTHNBTNNHTTNNBNHNBNNNNHNTBNNNHNNNBNHNNHHTNHNHNNTNN
BNHNHTNBNHBTNNNNNHNBHTNNTHBHNTBBTBNNHNNNNHTNNNNHTNTNTNNTNHNHHBNNHNNNNNHTHNHNNNHTBHNBNTNHNNTNBTHHNBHN
NNNHNTBTTNNHNHTBHNNBNNHNNNNTHNTTHNHTBNHNNTNNTTHBHNHTNBHNTNBHNHNTNHNBHNTNNHTNNNTNNHNTBNNHTHTTNNHBNNNH
TNBTBHTTNTTNNTBHHNHNNNNTNTNNNNBNNNNNNNHNHNNHTHHHBTNTNHTTTHHNNTNNTTNTNTNNNTHHNHNBNTTNBNTBNHTTHNTHBTNN
THNNHTHBNNNNHHHNNHHNNNBTBNTNNTNNTNTTNBNTNTNBTNTNNNBNTNBNNNNTNHNTHNNNNHNNNTNHTNNNNHNTBHBNBTNNNNTNBHNH
HBHNNTBNNNBNNNHBNBNHNHHNHHTNNNNHHHNTNHNHHTNTNNNNBBNTNTNHBNNNNBTNBTNHTTTNBNNNNHTHNBNHNBNHNHNTNTHHTNNH
NNTNHNNTBNHTNNBNNHTHHBBNHBHTNBNNNNHNTNTTBTTNNHHNNNBBHNNNNHTNTTBNTNNNHNHNHNTHHHNNNHNHHNHHTNNHNHHNTNNN
TNTTNNNHNHTNNNNHNNNNTNNTNNHBNTBNTTTNNBTBTBNTHBTTNNNTNNNTNBTNNHNBNNNTNHBBHTHNNNTBHHHTNNNBNNNBNTBNTNTT
TNNBHHHNHNTNBNNNHNNNBBTTNNBTNNNNTTHNNNNTBNHTNBNNHNTNNNNNNHNNHNTHHBTNHNHTBHNHNNTNNNTNTNNNHNHTHBHNBBNT
BTNNNNTBTNNNTNNNNNNNHTTHBHTNBNTHNNNTNHTTTHTNHNNNTNNNTNNNBHNTTNHNNNHNNHNNTHNNTTTHNNTNNTNNNHHHNTTNBNNN
TTBHBBBTNHTHTHNHNNNNNNHHHHTNNTNTTTTNBTHHHTNTHHNNNBNTNHNTNNNTNNNTNNHBNNBNNNNHNTTNNTBNNNNNHTHNTHNTNNNB
HBNNNNNHHTNNNBTNNNNTTNNNNNNHNHTHNBNBTNHNNTNTNNBHNBNHHHNHTHNHNNTNNNTNNTNNHNNNNHTHNTNHNHNNNNNNTNTNNNNN
NNTTHBNHTNTTNHTNNNHTNTNTNBHNNNHHNNHNNNHTBTNNTHBNNTTNNHTBNHBNHHNHTHBBBNTNNHHNNHHTTHTTNNNHNBBHHNNHNBNN
NHNNHHTHNNHHHHHNHNHNBNNNNTNHBHNNNNNTNHTHHTHNNNHTNNNNNNNTNNNBNNBNNNNHTNNHBNNBNTNNNHHNHHHTTTBTNTTHNNHN
NHNNHNNTTNNNTNNNNBTHHNNHTNNNNTHHNHBNTTHBHNTTNBTTTNHHNBNNHNNNHNNHNNBHTHNTNNNBNHNHNTNBTTHTHTNNNNNNNHBB
NBTNBBBTBTBNTNHHNNNNBNNNNBBTHTHNHNNTTHNNNNNTTNNNNTNTNNNNNNHNNTNNNTTTHBNNNNNHHHTNHHTNBNBHTNBHBBTTNNNN
NNBNHNNNTNNNBNHHHNTNTNHHTHNBNTTBTBTHTNHHTTHNNNNTTNNHHNNNNTHNNTTNHNTNTTNNHTHTNTBTHTBNNBNHTNTHHBNTBHNN
NHTNNNHTNNTTHTHHBHNNTTHNNTTTHHTBTTTHNTNTNNTBNHNTBHNBHNHNNTNHTNNTNNHBNNTNNTNHBNNTTNNBNNHNNNNBHBNNTHTN
HNHNBNNBNNNNTTNNNTNNNNBNBNNBNTNNNNHNBHBNBNTNTNNTNNNNHHTNHBNNNBHHNNHHBHNNNNNNTHNNNNTHNHNHNNTNBNHTNHNN
HNHTNBNNBNNNNTHTTTBNNNNNTNNBHBNHHTHBTNHNNNNTTNNNNHTNNHNNBHNNNNNHNHNHNBBTNBNNBTNTBTNNNNTTHNHHTHNNTHNH
HBNTNHNTHTNNNBNHNNNBHNHNTTHNTBTTNHHHNTNBNNTTNBNBNHTNBTHTHNNTNNTHNNNTTHNHTNBNNNHNBNBTNNNTTNHNHBNNHHNN
