TTBNNTNNNNNNHNTNBBNNNNTNNNNNNNNNNNBHHNHNHNNTTTNHTNTNNNBTTNHBNTNNNNTNNTNBHNHHNHNNTHNNNNTNTTNTTBNBTHHT
TNNNHTNBNNHNTTNHNBNBNHNNNNNNTBNHNTNHNNNTNBHNNNTHTNTHTHNTTTBBBBHTNTNNNHTNHTTTBNHNNTNBHHNNBTHNHNNTNTNT
TNNTNNTTNHNHNNBNHNTNHNNNNBNNNNBTBHHNNTBNNNNHNTNBNNNNTNHNNNNNNNHNNHNNHNNHNTNNTHNNNHBNHNHNHNNNTHHNBHNH
NNNNHTHBHTNNNTTNNBNBHNHTHHTTNTHNTBHHBTNTNNNTNNNTNTNTHTBHHBHNTHNTTNNNNNBHNNTNNHNHNTTTNNTNNHHNBNNHNTNT
NNHBNBNNNNHHNHNNNTHHNTBTBHBNHTBTBNNHTNNNHHBHHNNNHNNNTNBTNHNTNTHNNNNNNBHHNNBHNTNBHNHNBNBHHHBNNNBNNNNN
NBHBBNNHTHNTBNTHBNHNNNTNNTTHTHNNNNHTTHTNTTTHNHTNNNHTNNNTBNHHTNTHNNNNHNNTTHNNTBNNTBNTNTBBTNBHBNNTTTHN
NNNNHNNNBNNTTNNHHBHTNTTNNTTNTTTNNTNNNNNNNNTTBHNNBNHNTNHNNNNHTNHNNBNTNTTNHNTNBNNNNNNNHNTBTNNNNNNHNNNH
HHHHNNTBNNBNHNNNNBTBNHNHTNNNHHNNNBNTNNNNNNTTTNNNNNHNNTNBNNBNNNTNHNHBNHHNTNNNNTNHHHNNBNHNNHHNTTTHNNNN
HTTTTHTBNHTNTNNNNBHNNTTBNTNHTHNNNNNTBNHNNNTHHNTNHHNNTNTNTNNTNTTNNHNNBHBNHBHTHTBHNBTNTNNTNNTNNHHNBNNB
THNBNHNNNTHBNNBHTNBNHBNNNHHNHHNBTTNBHTHNNTNHNNHNNNNHHTTHNNTNHNNHBTHNNTNNNNNNNHNBNHHNNHNTBTNTHNHTNNNN
NNBNNNNTNTNBNTTBHBNNTNTNHBNTNBBNBNNTNTBTHTTNBHNHNHNHNHNNHNNNHNNBTTTTNNHTNTTNNNTNNNNNNNNTHNNTNTHBNNHH
BHHNBBTHNTBTBBTHNHBNHTNBNTNNNNHTNHHNTNNHHNNNNTBNNNHNNHHNNTBTTTHBNNNBNNNHNTNBNHNNTTTTNHHNHHNHHNNTNNNN
NNNNNNNTTNBNTTNNNHTNNBNNTTNNNNTHBNHHBHNNNNNHHTTBNTHBNTTHTNNNNNNBNBHNNHNBHNTBNTBNNBNNNNNNTNNHHNTNNNHT
NNNHNHNTNNHHNHNNNNHTNHTNNNBHNNTNNBNTHHTNHBHBNHTNHNTNNNNNTHNTNNBNTNNBBNBNNNHNTNBHHNNNTNNHTNNNTBNBNNBN
NNNNTNHBHNTNHTHHHHTHHBHBNNTNNNNTNNNNTTHHHNNNBNNNNBHNTNTTHNBHNBBHNHHHHNNNHNBBNNHBNNNTHNHNNTTHNTBTHNTH
TNNHHBNNHNNNTHHTTNBHNTHNNNNNNNTNTTTTNHTNTTNTNNNTHNTTTNHNNNNTHNNNHHNNHNNNTNTHNHNNNTBHNNHNTNNHHNNTHHTN
NNHTHNNNTNTNNHNHNBNNHHNHNTNTNBNBNNNHNTTHNNNTHTNBNBHNNBHTNTTNNTHNTNHNTNNHHNNHNNNNNNNBBNNTNHNHNNHHHTTN
NBTNBHTNNTTTNNNHBHNNNNBNTNNNNNNNTNTTNNBNTHTTTTTNNNBNHHTTHHHNNTNNTTTNNHNNTNNNNNNNHNNNNTBTBHTNHNHNTNTN
BNNNTTNHHNNNNNBNNBTTHNBTHNNHNNNHNTNNBNNNHNNNNNNNNBHTNTNHHTHNTTHHHHTNTNHNNTTBHTBHBNNNNHNNNNHNHNBTTNNN
NNNHHTNTBTNHNHNHTNNNNNHTBNNTNBBTBNTNHNNTBHBHTHTHHHTHNNBBNNNNBNBNBNBHTTBNNNTHTNNTTNTTHNNNNHHNTNTHNTTH
NTHTTNTNHNBTTNTHNNTTNTHTBNBNNNHNBNNNNNHHNNHNTNNHNNNNNTTTNNTNBBHTNHNHNNTNTTNTNNTNHNNNNNTNBHBNNNTTHNNN
NNHNBNNNNNNNTNHHTNNNNNHNHNTNNNHHHTNHHBTBNBNNNHHTHTNHNTNTHHNNBHTTTHHHNBNNHNNTNNNHNNNNNNNNBNNTTBNNNNTH
TBTNBNHBTHNNBBHBNNNHHNNNNNHBTTNNNTNTBBHTNNTTNHNNNNNTTHNBNNHBHTNTNNHHHNNTBNNTNBBNNTNHNNNNNHNBNHHNNNHH
NNHHTBTTHHNHBNBNBTNNNBNNNNNNTBHTHNHBHNNNTHHNHBHTHBNNNTTTNTBHBNNTBNNBNTNNBTNNHNNTHNNHHHHNTNNNNHTNNHNN
NTNNNBHHNHNNBNNHNTHBNNHHNHNBNNNNTHNHHBNHNNNHHBNNNBHNNNBNNNBNHHHNTNNHHTHNHHTHNNNNNNBNBHHHNNBBTNNNNHNT
NTTHNNHNNTBNNNHHBNTNHTHNTTNNTNNBBTNHNNBTTNHNNTTNBNBHNTBNNHBNNNHTNNHNNNNHNHNTBTHNTNHNNNHTNNNNHNBHNBNH
TBNNNHHTNNNHTTHBHTNHNNTBNNBTNNNNTBNHTNTTNNTHTHTNHBTBTTNTTHNTNNBTTNTNNBNBNTTHNTHHBHBHTHBNHTTHHNTHNHNN
HNNTBHNTHNNNNTNHTNHNNNNNBHTTHNNNHTHNHNNNHTTNTTTNBNBNHNNHHNTTNTTNNHNTHHHHHNNNNNNNNHBNTHNHNNBNHTNNNNHB
NNNNNNNTHNTTNHNHNNHNNNNNNNHTNNHNBNNTNTTNNBHHNHNBNHTNNHBHHHTHNNNTTNTHHBTNHNBBNBNBTNBNHNHNNHBTNTBNTNHB
TNNNNHNNNBNNHNNNHBNTBNNHNNHNNBHNHNNNNTNTNNHHHNNBHNBBHNNBNNNHNHHHHBBNBNTTNNTHNNNNNNHNTHTBNTNTTNTTTNBT
TNTNNNNBNTHNNNNBNNTTHNHNNTNBNNBNNTTNNHNNNNHHNNBNTHHHNTHTNBHNTTTNNNBTBBNTNHHHNNTHBHNNNHTNNNNHNBNNHHTN
HNTBNNNNHNNBHNHNNTHBNNNTNTBNNNHNNNBNNNNNNHNHNTNNNNTNTNTNHHBTHNNHTHNNNHBNBTNNTTTHNNNHTTBNBNTTNNNTNHHN
TNNNTTTHHNNBNNHHTHNNNNNHTNNNNHTNNNNNTHTNNHHNTNHNNNNNBHHNHHBNNHNNTNNTHHTHNTNNNTHTNTNBHHNNBHBHNNNNNNNN
NNNNNHNTHNNNHHNHTTTTTNNHNTHNHHTNNNNNHNNNNHNNHHBHTHHBNHNNNNNNNNTTNNNBBNNBNBNTBNNHBNNNNNNTHNTTNHHHNNNN
NBTBTHNNNNHBBBNHNHNHNNBHTHNHHBHHBTTTTTBTTNBNHHTNNHNTNHHTNTTNNTNNNTNNHHNNTHNNHNBNNTNHBBNTTHTHHNTHNBTH
HTNTNNTHHTTNHNNNNNBTNNBNTHTBNNNNHHNNHHNTNNNNTTNHNNTHNBTNTNHHNHTHBNNHTNNNNHTHNNNTTNHTNTHNTHNNTBNNNTTT
NNHBHNBHNHNNHNTHNTNTNHBHNTNNTTTBNNTNNHHHNNHNBHNNHHNHBBHBTHNBBTNBNNTHHTHHNBNNNHNTNTNNNNNHTBNBNTTHHHNN
NHNTNNTHNNTBBHNNNBTNNNTNHNHNBNHTTNTNNBBNNHNNHNBTNHNBHNTHHNNNHNTTTNNHNHTNHHTNTNNNNNTHNNNNHBTHNNTNNHTN
NTNHNNNHHNNHHNTBNNNNNNNHNNHHTBBNNHNNTNTBNBTHNNNHHNHHNNBNNNHHNTNTNHBNHTTTHTNNNNNNHNNNBNHTHNHNNHBTNNBN
BNTHHNHNNNTBNBHNNHHHNNHNNNHNTTNHNNHNBNNNHHHNNNNNNNNHHNNTNHHNNNNTTHTTNTNNHNNTNNNTHBNTNNHNHNHBTHHTHBBH
HHTHNNHTNTNTHNNNTTHNBHNNNNNNNNNNHNBTNNTHNBBNNTNTHNNNTHBNNNNNNNNNNNNNNNNHNTHNBBNHNBHTTHBNNHNTNTNNHNNB
TNNHNNNNNNNHTNNHTBTHNNNHBTHNNNNNBHBHNNBTNNNNBNNNNHHTNNTNNTNHNHHNTNHTHHHTNNNTNNNNNBTNNBTTNNBHNTTTNTHN
NBNTHTHTHNNTNNNNHNNNHTNHBNHNNHBNTHNBNNTTHHNTNNTHNHNNNTNNBTNNBTNTTNTTNNNTHTTNHNNBNHHNHHNTNHTNHBBHBTTN
NBTNHTNNHNTNNNNNTNNNBTNHNTTHBTTTHTNNHBHNNNHNTTNHNNNTNTNBHNTNNHHHTNBNHHBTHNHTTHTNNTNNNHNTNTNTNTHHNNHH
HNTHNHTHNBBNNNBTHNNNNTTTNNBNHNTHHHNTNTNTNBNHNNHNTNNTBHNNNNBHHNTNHHTBTNTNHNHNNNHTTBHNNNNHNNHTNHTTNTHT
NHNNNNHTNNBTHNTTTNTNHTHNNTHHTNNNNHNBNNNNNHNNHNNBHNHBTHBHNTNNNTNNTHNTBNNNNNBTNNHNBNNNNNNNNTHNNBNHBHTH
BNNNNNNTTNHTHNNBHTTNTNNNTTNNNBHTNNNHHNNBNNNNTTHNNNBNNHHNNHTHBHNNHTHTTNNTNNNNHNTNNTNTNBTNHHHBTHBNTTTN
NTHTHNBNHTNNNNBBNBNNBNTTNBNHBNBHNNNNTHHNHHNNNHTHTHBTHNNHNNNNHNHNNBNHNNNNBNHBNNNTNTNBNNHNTBTHNNHNNNNN
NTNNHNNTNNNNNHNBNNNNTNTNNBTTNTTHNNTNTHTNBTBHNNBTHNHNNNBNTNNNHHTTNNNNNNNHNNNTTBNHNHHBNHTNNNBTTNTTNTTT
BNNBHNTNNTNNHNHNHHTNNNHBTNNNBNNTHBNNBHTNNNNBBNNTHTNNNHNTNHNNTNHTNHTNNBNNNNNNTNHNNTTNTNTTNNNHBNNHBBNN
HTBBNBNNNHTNNNHNNNNHTBNHNNNNTTHNNHTNHNNTHNNNNNNHHBNNHNNHBHBNNTNNTNHNNNNTHHNHHTBNTTNNBHHNHHNNNNTHNNNT
HTNNHTNBNNHBNHNNBHHNNNTNHNNHHHNTBHTTNHHHHTHHHNNNNTHNNTTNTNNNTNBNHBNNNNNNNTNNBHBBHNHHNNNHTNTNHHBTTHNH
NTBNNNNHNNNNNNNNTNNHHHTNTNHNTTTTNHTNNHHNHNHNNTNNNNNBHTNNNNNBNBNNNBTNTNHNBTTNNHHNTHHNBHHHHNNNNBHTNNBB
HHNHNNTBTBBNTTTNNNNHBNBBNNNTTHNHNBNNBNNHTTHNNHBHNNNNTHNNHTHHNNNTNNHHBTNHTTTHNHHNTHBBBHNNHNNHNNHTNNNN
NHTHNBNNHTHTNTNNNNTHNHTNBNTHNHHHNNBTHNNNNTNNNTNTNNNTNNTNTNNNTTBNNHHNNNNNNNNNNTBNNBBNNTNNNNNTHNNHTNNN
NTNNTTNNHBNTTNBHTNHHHHNNHTNTNHHNHNTHTNNNNTHNTNHNHBNHHNHNNNBTNHHNBNBNHNNHBNNTNBNTHHTTNBTTTTNHHHBTHTNN
BNNNTNNNTBNNTHHNBTNNHTTTNNNNTTHNNBNNHNNNBNNNNNTNBTNNTNNHTNNHNNNNHHBNNBNNNNHHTHNNNNNHNBTBNNBTNNTNTNNN
NTNTHNHTNNBNHNTNNHNNTNNNNTHBNNTNNNNNTTNBHHTHTNHHNBNTNHNNNBNNNHNNTNNNNBHHTNNNNNNHNNBTHNTNNHTTHHBHHTNN
NBNHBNNHNNNHNNNNHNBNTNHHNBNNHNTNNBHTHNHNHNHBNTHHNNNNBTNTNNHTNTNTNNNHNNNNNHBBBTNHBHNTHNBHNNHHNNNNHNHH
BNHBTNBTTNNNBHHTNTNNNNNTTTNHHNNHNNNNTNNTBNHHHHNHNNNTTTTNHTTTHHNNHHTNNBNNHNTTTTNHTNTTTHNNHBNNBTTHTNNN
NHNNTNNNBHNNHNNNTBNTHNHNNNTNNNBHBHTNNNNNNBNNNHHHHBTHHHNHNHNTHTTNNHHBHHHNHBBTNNHTHNBHNNHHTNNNBNHNTTTT
HNTHNBTNNNNTHNHNTNTHNNNNHHBTHNNHHTBNNHNBBTHNHNTBTNTNNNNNNHNNNNHHTNHNHNNNNHHNTNHBTHNNHHNHTNBNNNHNTHNH
NHHNHNNTHNBNNHNTNHNNHBBBHNHHNHBNTNTBNNTNNHTNTNNNHHNTHNHTNNHHTBNBNHNTTTNNNHNNNNHNNNTNTHTTHBNHNBNHNNNH
TNNTBNBHTNTNTBNNNBTBNHHTNBNTNTNNNBHHTHHNHTHNTTNTBTTHHNHHNTNBHHNHNTHTHNNNTBBTNNHNBNNNNNNNNNNNBNNNBNTB
NNNNHHHNNTBNTTNNTTNTBNNNHTHTBNBNHBTTBHHNHNNTNNNNNNNHNNNTTHNHTNNNTNNTNTTTNNNNTNNNTNTNNBNNNBHNNNHTTHNT
TNHBBNNNNNHBNHHNBHNHBHHNBNHHNHNBNBTTTNNHTNNNTNTHHNNBHNTNNNBHNNNNTNNNBNHHNNNHTNBNHNNHNHNNNNHTNNNNTNBN
NNNNHHNTTTTNNTHHHNBBNBBHBHNNBNNNHNNNNTNNNNTHTHTNHNTTBNNNBTNHHNTBNHHNBNNBTHNTHNTNNNHNHNNNNNNHNNNNNHNN
NNBNHNTHNHNNBHNNTHHTNNNNNNNHHNNTNNBHTHHHNNBTTHNNNNNNNNTNTHTNTNTBNBNNNNNHNTNBTNTHNNHNNNTBNBHNHNHNNNHH
BHNNTNNHHHNNNNNBNTTTNNTBNBNNNNNNHHBNNNHTBTBTNHTTHNHNNHNNNNBNNNBNNNNNBTNBTNTNBTHTBNBBTNTNNTNNBNNNNNNN
HTNTBNHNNNNNNTTTNHNTNNNNNTNNBNTNNNNNHNNNNNNNHNTHNTTTHHHTNNNNTNNTTNNNNBNTNNNTTNNNBTTTNNBBTHNNNNHNTHNB
NNBNHNHBBHNNHTNNNNHTNTNNNHTBNNNTNNHNNHNHTNBNTTNNNNNTTNBNNHNHTHNBNTNHNNBBNTBNNBNHNTTTNHBHTHNHTTNNTNHN
NHHNNNTNNTHNNNNNHNNTHTTHBTNNNNNNNNNNHNNTHNNBNNNTHNNHNNNBBHNNTHBHBTTNHNNBNNHNTNNNHNNTNNNNNNNNHTHHTNNT
NHNNHNTTNNHTHTTNTNNTHNNHHHNNNTHNNNNTNNNNBTHHTNTTNNNBTTBHHNNNTNTNBNTNTNNNHNNNNNTHBTNNBNHNNNNHTNTNNNNH
HNNTHBBNNBBNTHTNBBHNNTNNTTHHHNNHNHNHNNTNTHTNTTHNNTHNNTHNNTTNBTNNNNHTNTTHHNNNHNTHHNTNNNBTBNBHHNHTNTBN
NNNNBTNNTNNNNNNNNBNNHNTHHNNTNNNHTTNTNHNHHTTNNNNBNHNHNNHHNNNNTTTHHNNBNHHNHNNNTHBNTNHNNNNHNNHTNNNNNNHN
NHNNNNNHNNNNNBHNHNNTNNHNNNBHNNBNTHBHNNTTNHTNHTBNHNNNNNNTBNHBNNNTNBNNHNNNTHBBHNNNBHHHHTHNHHBNNTTNNTNT
NTHNHHBNTHNNNNBNHNHTNNBNHNNTNNTNTNNHHBNBNHNNTNNTNNNBNTNNNHBBTNBNNTNTHNTNNBNNTBNHNBNTNBHBNBNNNHTNTNNN
BHHTTHNHHHTHNTHTNTTBNNTBNNNNNNNTNNHNBNBTNBHNBHNNBNNTNHNNNHNNBTTNHNNNHNTHTNNHHNNNNNNNHHHHBBTHHTTTNTNH
NHNNHTNBNBTBBTTTTTBBBNNNNHHBNTNNTNNNNBNHNNHNTNNNTBHHHHHNHNTTNTNNTNNHNNTBHNTNTBNNHBHNTTNTNNTHHBBHNNNN
BNNHTNHHTNHNNNNTNNTNHHHHNBBNTTTTNNNNHHNNNTHHBHTTNNNNNNBNNHNNHHTNNNBHNNNNTNNNTNNBNNNBHHNNBTNBHNNTTNNN
NNTNHBNNNBNHBTNNNNTTNNNHBHTTHBNNTNNNTNNTHNNBNHTNNNNNTTNTNBNHNTNNNNBTBHHNBNTNNHNNTNBNNTNTNTNNNNNNBHTN
NBNNNTNHNTTNTNNHBTTNNNNNNTHNHBNBNNHNNNTNNNNNNTBBHHTNNTTHHNBNNNBHBHBNBNNTNNNNNTTNNTNNTTNBNBNHNNNNNNTH
NNTNNHNNNNBNHHNNHNNTNNHNNBNNBTHNHBBTNNNNNBNNTBBNTTNTNHNTTNNHTNNTNBNTNTNNNHNNNHBTNNTNNNHNNHHTNNHNNNNN
HTNNHHNNNNHNNBNNNNTNNNNHNTNNBNNTNHBNNTTNNBTNNTNNNNNTHTNHHNNTNNHNBNHTNNBBHTNBHNHNNTBNNHNTBBHNNNNHNNBH
HHHHHNBBBNHNTTHBHNNHNHHNHTNBHTNHTHBTNTNTHTBHNHNTNTBNNTNHNNNTNNNNNTTNTHNNNNBHNTNTNNNHNNHNHNNBNHHNNNNN
HNNNTNNTBBTNBBHTTTNNBNHNNNNHBNTTTNBHNNNNNNNNNTHHBNTNTHBTNNNNNHTHHNTBHNHNNHNTHHHHBTNNTNHNBHNNHBBNNNNT
NBHHBNHNNNNNNTTTBTTNNHTNNNHHTNTNBNNNNNNTTTNBNNHNNNTNTHNTNNHBHNBTNTHNBNNHHNNHNHBNNTNNBNBNNNNNTNNBHNTH
NNNNNNNTNHTHBNNBTBNNNNHTNHNHBNNTNNNBTTTNNNNNBNBNNNNHHNBHBNHNNHNHNTTTHBNTNNNBNNNTNNHBTNHNNNNNTNTNBNHT
NHTNHNHNHNTNHHNNTNNNBNNNHNNNNHTHBBHNNNNBHNNHNTNNHBHTNNNNNNNHNTTNHNTNHNNHNTNNHBHNNNHHNNTNHNTNBHNNNNBN
TNNNNNTNBBTNHNNNBTNNBHHNNTHNBNNTNNNBTNNTBNNHHHHBNHBTNNNTHNNBTNHHNNHNNNHNNNHNNTHNNHBBHHNNNTTNTHTTNNNN
NNNBTTTHBBNNTNBTTNNBBNHTHNNHTTNHNNNHNTTBTTNNTNNBTBNHNHHTNNTNTTNHHTNTTHNNHTNBHNNHNBHTHNBNTNNTNNNTNNTT
THNBBNHHNHBTNNNTNHHNHNTTNTNNHTNNTNNHHHHNHNTHHNNTTNHNTTNNTTNNNTHTNTHTNNNBNTHTNTHNNNNNHNNTNHNNHNNNBBNN
NHNTNNHNTNTHTNNTNNTNBNNBHTNTBNNNBNHNNNHTHTTBNTTHTTNHTTNNTTNNBNHHNNHNHNHNNNNNBTTNNNTNNBNNNNNNHTBNHHTN
HTNNNHNTNNBNBHTNNNNNNBTHNHHNBNHBHNNHNHNNTBBNNNNNNBBTHHHNNHHTHTNHNBNHTNTHNNNNHHNNHBNNNNNBNNBNBTNBNNTN
TTTBNNHTNTNNHNNBNNHHTNHHBTNHNNNNTHTNNHNHHNNNBNNHHNTNTNNNNNTNBNNTNNHHNNBTBNTNNTHTHTTNHHNHNHTHNHHNTTTN
BNNTNNTNTTHHNNNNNNHTNTTTNNHTHHHNBHNHHHTBNTTNNNHHBNHHHTNNNBHHNBTHTHTNNHNHHHNNNNHNTNBNNNTBNHTHNNNNNNNT
TTTNNNNHTHTNTHTTTHHNNNHNBBNBHNNNNTHNNNNHNTTNNNNTBNTNTTHHNBNHNNHHHTTBHHNTNTHNNHHNNNNTHNTNHBNTHNTTTHNN
NNTHHNHNBTBNHHNHNHNHTNNNTNNBBNNNTNNNNNTNHNTNNNHNNHNNNTNHNNBHTTTBNNNNNNNNNNTHTTNTNHTNNNNBTNTNBNHHTTNN
TTNHBTNBHNTNNHNHTNHHNNNHHBNBNNNTNNNTTHNHTBNTNHNTTBTNNNNHTNNNTNNBHBTHNNBBHNNHTNTHHHBNHHHNNTNNBNNTNTHN
BTNNBNNNNBHNNTHBHBNNBNBNTNNNNBNHNNNNBNNNHNBNBNNTNNTNTNTHHNNNTBNBTNBNTBNNBNHNNHNHBNNNNNHNNNNNHNHHHNNN
