TNHNTTTNHTNBBNNTHHNNNNTNTNNTNBTNNNTNNBTHHTTNBNTNTNBHHBNTTTNBBNHTNTTNBNNTTHNNNNNTHNHHBHHNTBHHTHNNHNTT
NBHNNTNHHTNNNBNHNBNNBNNNTNNTHNHTNBNTNTNNNTHNNNHNTNTNNBHHNTTNNHNHHTTBBBNNNNNNHTNNNNNTHNHBTHTNTNHBNTNN
TNTNTNTHHBNNHNNHNNTNTNBBHNNHNNTNHBNHNHNNHNNNBBNHNNNNBTNHHTNNHHTBNTNNNTNNNNTNBHHNNHNHTNNNNHNHTNNNHHTH
NNNNHHNTNNNHNHNHHNNNBNTNNBNNNTHNNNNHNTNTTBHHNNNHNHNTBNTNNNNNTNHHNNHNNNNHNNBHNNBHNTTNNNNNBTNNBNNNHNHT
TNBNNTNNTHBNNNNHHNNNHNNNBBNHTTTHBNBBTTTBBTHNTNNHNNNNNNHNNNNNTTTHNHNBNTHTBTNNNNHHNNBNTNNTNBNNNNHNNNTN
NNTHNHNNNBBBHNNNTHHBNNNHNNNNHHHNNNTHHHTNHNHNNTNTNBHNNNHHTNHNNNTNNNNNHNNTHNNBNBNHNHTNNNNNBTNNTBNBBBNT
TTNNNTNNNNHBTNHNTNTHNNNNNNNNBHHHHTTHTNNNNNBBNNTHNNBTNHTBTBTNNTBNTHTHNBNNBNNNBNTNNTNNNHNTTNNNNNBHTTNN
NNNNNHHNHHTNTNNNNNBNHTHNNNNNNHNTHBNNNNHTNNTNHNTNNNNHNHNTBTTNNNTNHNTBNTNNHTNNTNNHNNNBNNBNNTNHTHBNNHHN
HNNTTTNNNNNTNNTTBNTTNNTHHTHNTTNTNHNNNNNBHBNBTNNHBNBNTBNNTNNHHTHBNBNNTNNBNNNHNBBNTNTNBTNNHNNNBHTNTBHN
HNNNNHNNTTNHNNNNTNNNHBNNBHNNNNNNHNHNNNTTNNBNNNNNBNNNNNTNTTNTHTNNNNNTTNHTHNHNHTBNNNTHTTHBBNNNNTNNNHNN
NNNBNNTTBTNTNHHHHNNNHNHNTNNNTHNTNBNNNNTTNNTBNTTNBNBNBNHNTNTNTNTTNNNHNHHNNNNTNHNBBTNNNBTNNBNHHNHNNTNH
BHBHTNBHHHHTHHNNNHHNNTTNTNNTBTNNHHNBHHNNTHNBTNHNNNBHHTNHHNNHNTNNNNHHTNNHHNNBTHTHNNTHTNTHHHTHNTNNNTBT
HHNNNBHNNTBTNBHBNTBNHNNHTHNNNNHNNNBNNBNHNNNHTTNNNTHNNNNHBNNTHNTTNTBNHNTHNNTHHTNTTHHNNNBTNNNNTNNNNNNN
NNBBBBNNTNBNNNNHNBNNNNNNNNTNBTTNNHTTNTNBNHHNTNHTNBHTNNBTHNNNTHTNHHNBNNHNNNHNTNNTTNHNNNTNBNHHHNHTNNNT
NNTTNTBTNTBHNTTNNHNNNBNTNNHNNTHNNNNTNNNTNNHHHTHNBTTBNBBTTNTHTBTNHHTHNNNHHNHHNBTNNNNNNTNNNTNNNNHHNBHH
NHTNNTTNNNHHHBNNTTNNTTBBBNNBBNTNTHNNNNTTNNNHTHNNHTNNNBNNNNNNHTHNHBNNTNNNBNTTHTHNBNHNNNBNNNNNBNHTBNHH
TNHBNBHHHHNNNNNNBNTHTTNNTTHNHNNTNHNNTHBTNNHHNTBBHTTTNNTNHHNTNBNHNNNNHNNHTNHNBBTNTBNNTNTNNNTHTNNNNNTN
BNTHBNHNHNNHHHNNNNTTTNTTHBNNNTNNNNBTNNNNTTHTTNNNHBTHNNNNTNTNNNTTNNNBTNTNTNNHHHNNNNBHTNTTNTTBNNNNNHNB
BNHTNNTHTNNTBTHTTNHNTBTNBTNNNNHHTTNTNNTNNTNNNHNHTHTNNBTNNNNBNNTNNTHNNNNNNNHNNHHNBNTNNHNTNTNHNNNTNHNN
NNNHHHTBHNNHHNNTNNNHTTNNHTNTNTBNTNBNNTTTHHNNHTNBHNNNNNHNNTTTNBHHNNTHBTBNHNNNNNNNTNHNNNNNNNTHHTTNNHNH
TTBNNNTTNNNBNNTNNTNNNNNBBNHNTTTHHNNNHNNHNTBHNNTTNBHNHNHNNNNTNTTHNNNBTHHBNNNNNTHNNNTNNTNNNBTHHHNNNNTH
BTNTNTNNHNNNNNNNNHNBTHNNNTHBTTNNNNNNBBNBTNNNHNHNNNHNNNHNTNNNNTNHNHHBTBNNNNNNNTBTNBBNHNNHNTBNBTNHTNBT
NTHTBNNNHNHNNHTHHTHTNNNHNNBTNNNHBTTHNBHNBNNNTNTHHHBBNNHNTTNHNTNBNNHHTNNHTNNHBTNTNHNHHNTNNHHNNNNBNHNN
NNNNNNNNNTNTTTNNTTNNNBNHNNNNTNTNNTNBNBNNNNTNHNHBNHNHNNTNBNNBHNTNNTTTHHHNHTNTNNTTHBHNTBHNHNNNHNNBHBHT
NTBBTHTNNNNNNTBBHNNNBBNBHBNTHBTTBTNNTBNNNNNNBTNHNHNHTNTNNNBNNNNBHNNBTBNNTHTNBNNHNTTNNTNTNHHNTNBNNNNN
NNBNBNNNTTNNNBNBTNTNTHTTNHNTHNNNNTHNNTBTNNNNHNTHNNNNBHBNNNHTTTNNNTNNHNNTNNHNNNNTNHHTHNNHBBTBBNNNHTTN
NTTBBTNHHNNNNNTHHNNTBHBNNHHNTNNHBBNNNHNNHTNNNNHTHNNHNNNBBTNNNBNTNNTTNBNBHHNBNNTTTNTHBTNBHTNNNTBNHBNT
TNNBNBNNNNTHNNTNNNNHNNNTBBTNNTBNBHNHBNTNNHTNTNNNNTNNNBTNNHHTNNTNHTHNNNNBTNTTNHBHHTNNTNNHNTTNNBTTNNNT
BHTNHHHNNNHNTNTHNNBNTTNTNTHHNNTTNHNHHNBNTNBNNNNTHNNNTNTHHNHNTTNNHBNNNTNHHNNTNTHBTTNNTNNNNBNTNTNNNNTN
NTNNNNNBNHHHNNHNNNNBNNBNTNTNHNTNHNNBHTNHTNNNHNNNNNNNNNNNNBBNHNNHHNTHHHNTNNNHNNTNHNNNNTTHHNNTNHNTNTNN
NTNNHTTNNHTNTNTHNNNNNHBNNNNNNHTNBNHNHNNNNHNNNNHTHHHNHNHNNHHNBHHNHTNNHBBNBNNBNTNHHTHNHBTTHTBNNTHNTTNT
TBHHBNTNNNBNNNNNNNBNBBTTHTTBNHBHHTNTNHTNHTTNHNBBHNNBHBNNNTNTNTNTNTHBNNNBTNNNNNBNHNHNTNTNHHBNTNTNTNNH
HNBNNNNHTNTNTNHNTNNNTNNHTNNTNNNNHNHBHTNHTHNNTNBNNNTTNNBHNHNNNHNNHNNNTNBHTHTNBNNTNHNTNNBHHBHTNHNHBTTT
NTHNNNNNHNHNNNNTTTHHTBNNTNHNTTNHNTNNBNHTNHNNNNBHNTHNNTHBTTHNNTNTNHNHTHNTNNNHTTNHNBNNNTHHHHHBHTHTNHTH
NHHNNHNNBNNBNHNHTNNNNTNTBNNNNNTHHNBTNTTHBTNNTNHTNHHNBHHNNBNHNTNHNBBTNNTTNBHBTNNNNHNNHBHTHNHHNNTTNBHN
NTBNNNTHNNNHNNNNNNTHNHHHNBNHNNNHHNBTNTNBNNNHNTNNNNNTHHNTBHNNBNNNTHNBNTNNBTNNNTNNNNHBNNNHNNNHNTNTNNTN
THTBNNNNTNNNTHBNNNNHTBNNNTTNNTTNHHNNTNTHBTNNHBNNHNTNBNNTNNHHNNHHTBNNBNHNNNNHTHBNHHNNNBNNTTNNNBTNNHNN
HNHNNNNTBNNTTBNNTHNBTHNHNNNBHHHNHNTHNNNNNNBNBNTTHTTNNHHBBNNNNNHBTNNNHTHNHTTNBNNNNTHHNNNBTTNNNHTTBHHB
HHHNNNTTTNNHNNHNNBTTNNNNNNTTTNHNTNHNTHNTNTBNBNNNHNNHNTNHNNNNNTNHNNNNHNHNNHHBHBNHNNNTHNHBNBNNNTHHNHBN
TTNTNNNHHBNNTNHNNNTHNNNTHNNBHHBNNHNNNTNNHBNBHTNTHHNNNTNNTHNNNNHNNNHHHBBNBNTNNNHHNTNNBHTTTBHNNNBNTNNT
NNBNHHNNNNBHHHNNTNTNBNNTNHBHNHNNNBNBNBHNNNNNNNBHNNTTHNNNTNBTTTNTBHBHBNHTTNNNBNNTTNNBNTTHTBNBNNBTHNHB
NHNTNHNHNTTNNNHNNNNTNNNNNNNBTNNBNHNHTBHNHNHNNNHBNNTTNTNTNNTTNHNTTBBNTNTBNBTTBNNNTHHTNHNNTTNHTNNTBTNN
TNNHNNNNNHNHHNTNNHBHBTTBNNNNNTNTNTTNNHHTBTTNNTTNHNNBNHHTTNBNBNNTNHNNNNNHBNHHNBTTNBBBTNHHTNTNBNHNNBHT
BNNTTBBTNHHNBNBNNHBNHNNTNNHTBTNNTNNHHNBTHTNNNHBNHNTHNNHTNHHHHBNNNNNBHNNNTTHHTNTBTNNHHNBHTNNBNNTTNHNH
NNNNTNNNBTNTHNTNNHNNHTHNNNNNNNNNTNNNHTBHNHNNTHHNNNBNHNNHHHHNNNNNNTNTNNBNNBBNBNHHBNNNTNNHNNNNNHNBTNNH
HBNNTTTNTHNNNHNNBHNNNNHTNHNNHNHHHTHTHBNNHHNTHNHBHNNNHBBNHNTTBNNNTNNTNNHNNTNNNNNNNTNNTBHHNTBNTTTHHTNN
NHHBNHHHNNNNNBNNTNTBHHNTTHHNTNTNNTBNNBNTHTNNNTNNNNNNTNNNNNNNBHNNTNTTTNNHNHNHNHHNNTNNNNNNTTNTHNTNTNBH
HBNTNTTHNNTNTNNTTNNNNHTTBNHTNTNBTNTNNNBNNTTNHTHNTNNTNHBBHTNHNHNNNNNHHNTNNNNHNBHHNNNNNNNNNBNHTNHNNBNH
TNHNHNHNNNTTHBNNTNBNTHHTTHHNTNBBHHTHHHNNNNHHNHNNTBTHBHTNHNBNTBNNHNNHTNTHBHNNNHBTNNTTNHNNHHNNNBBHTNNN
NHTNNNNHNTNHNNNNBNNHNTTNHNNHTHHNNNNNNBTNNNNHBNTNNNTNNNTHNHNTNNTNNNTNNNNNHNTBTNNNNNNNHNNNHNTHTNTBTNNT
TTHNTBNNNNTNNNTNNTBNHHNNNTNNNNBHNHNNNNHNBNNNHHNHNNTTNNHNNNHHTBNBHNNNBNNNNNHHNNNNTTNTNHHBBNTTNHNTNHHB
HNHHHHNNNHNTNTNHNNTTNNNNHTHNTNNNNNNTTTNNTNNBHNNTHNTNNNNNTNHNNTNNNTHHHTTNNBNNBBHHNTNNNHTNTNBNHTHHNHNT
NBNNNHHNNTBNNBHNBTHTNBTTNTNNNBNBBHHNNNNHNHNTNNNNNNBHHBTBNTTNNHHNNNTBNNNNHHTNHTBNHHNHBNNHTNNNNBBBHNTT
NTNNNNTHHHTTNNBNNNNHNBNBBNBNNTNNNTTNTBTBTHHNNNHHHNNBHNNTNHHHTNTHNTTBNNHHNNNNBHNNNNNNNNNNNTBTNHNNNNNT
BHNHTHHTBTNHNNHNNNTBTNNNNTTBHHNNNNNNNNTNHNHBNTNNTNNBNNNHNTBHNNNNNTTHTBBNTNNTTTHHHNNNHNNNTNHBNTHNTHNN
NHHNNNNHBTHNNBNNNNHBNNHHNHTTHNBNNNNBHHTNHNNNNNHHTTTHHNTTTNHNTNNNHNTNHTNNNHHHTHTNNTTHNNTNNBNNNHNHTNTH
BTBNTNNNNNBNHTNNTTNNHHHHBNNTHNTNNNTNNHHBNTTNHBNTNNHHNNNHHTNHBHTNTHHBNNTNNTTHNTTTNHTBTBTNNNTTNTTNNNNN
TBTTNNNNNTTNBHNNNNHHBNNNNTNTHTNNBHHBHNTNNNNNBHNHNNNHNHNHTNNTNTNNNTTBNBBNNNNNNNNNNBTNBNNNHHTNNNHNBNTN
NNNHTNBNNNNTHBBNHBNNNNNNNHNHHHTBHHHNNNHTNNHNNTBBNNHNNNNHNHHHNNNTNTNBHNBTTNNNNNBHNTNNNNNNNBBTHTNNNNNT
NNHNTNNHNNTHNTNBNNNTHNNTNTNNHTNHHBNNNHNNNNNNNHHNTTNNTNHTTNNNNNNHNNHTNNTNHNHTNHNHNNHNNBHNHTTHNNNNNNNN
BNHNNHHHHNNNNNHNHNBTHHHTNTNTTNNNHNNTBTNNNNNNNNNTHNHBNNTNNNTBBBNNNNBNHTNTTBHNNHBNHTHHTNHTHTHNNNNNTHNN
NBNNNHTNNTTHNBNNNTTNTHNTHNNNNHNNHBNHNNNNHNHTHNBNNTNHNHNNNNNNNNHHTNTHHHBNTTNTNTTNTHNNNNHNTBNTNNTNNNHH
NTTNBTNTTNNTNTNNNTNTHNHHNNHBHNNNNTHNHTNNHTTTHNBNNNHTNTHNBHNHTNHNBTTTNHNBHNHNNNHNNTNTNNNNNNNNNNNHNNNH
NNNTBTHNTBTNTNHBNNNHTNNTNHHHBNTNNHTNNHBHHNTHBHNNTNHTNHNTNNNHNHNTTNNBHHNTBTNNTTNHNHNBHBNNNTTNNNHNNNBN
NHBNHTNNNHHNNTNNHTHHTHTBTNTNNHHBNNNHNNNBNNNTNNHHNNHNNTHNHBNNNTNHNNTHNNNNNBNHNTHHTNNNNHHNBHHNNNNTNNHN
NNNTHNTTHHNNNHNNTNNNHBNNTTTNTNBNNBBHHHBNNNTHNBTHHTHTTTHHTHHBHNBHHTNHBNNNBNNHNNTHNBNNBTTNTNNNTBTTHBTN
NTTHTTNNNNBBNHHHNNTHNNNNNTBHNNNHTNNBTNHNNNNNTHBNBBNBNNNTNHHHNNNNTNNHBNNNNHNHBNHNTNHTHNHTTTNHTTHTTNTH
NBBTHNTHNNNHTNTNTTNTNHHNNNNNTHTTNHNTHNHHNNNNNBNNHHHNNNNTNNNHNNNHNNNNNNTHHBNTNNNTHNTTHTNNBNHTNNBNHNNT
BHHNHHNBNNTTNHNHHHTNTTHNHNTBHTTNNNHTHNTTNNTNBTHNBNNBTHNTNNNNNNNHNBHHNHNHNHNHNTNNNHNNHHHNTHNHNNNNHTHN
BNNNNHNBNHNTBNTNBNNNTNBHHNNNNNNNNBHNNTTTTNBHNHNNNNNNNHNNNBNTNTNHTNNNBNNNHTTTNHHNNNNNHHHNNBNHTNNTNHNH
NNNTBHNTHNNBTTTNTHTNNHBHNHHTNTNNHHHHTHNTHTNNNNNNNTNHTNTNTHTHNNNNHNNBNNTHHHHBHTNNBBBNNTNNNNHNNHTNNNBH
HNTNNNBTHNTNNHTHTHHNHHHNNNTBNNTNTNBNNTNNNBTHTNBHHNBNNNHTHNTNHTHTNNHBHHHTNTHHBNNTNTNHHTBTHHBNTTNTTHNN
NHNTTNNNNNHNNBNHTNNHNNNNNNNNBNNNHHTNNNHNNNNNTHNNBTHHHTNTNBTNNNNHNNNBHHNNHTNTTBNTNNNHNHNNBHNBTNNBHBTT
NNHNTBTTNNTTNNNTNTTTNNHNHNNHNTNNHNNNNNHNNNHHNNHNNNBNTNHNNHTNHNNNNTTNNBHHNNNNNNBNNNTHTNHNNNNNHNNBTHNN
HHHBHHNBTNHBNNNNHHNNHNNHHNNNNNNNNNNHBTHNNNNNNBTNHTHBTNNNTNBTHNNTNTBNTHHNNNTHBNBNNNTNNNTTNNNHNTNTNBNN
NNTNHNNNHNNNTTTTHHNBHTNTBNTNHNTHNNHNHNNHTHNNNTNNHNNNNHNHHNNNNNTTBTNBNBTNTNNNTNTNBTNNTHNTTNNNNNTHNTTH
HBTNHTNNNHHHBNHTHTHNNNNNNNNNTNTHNTNTNHNNBTNHBTNNTTNTNBBHNNTNHTNNNTNNNBNTHHHNNTNTNTHHTHNNTTNNTNNTNTHN
HNNBHHHNHTNNHHTNHTBTNNNNNBHBBNNHHNTBNBBBTNBTBTTBNNHNHBTTHNNNNNHNNTNNTNNNBTNBBNBHHHNNNNNNNHTNNNNNNTTN
NNTNNNHNHTHNHNNHBTTHHHNBTHHBBHTNNTNTBBNBHHTHNHNTTHNBNNNHNNNBNBNNTBNTNNNNNBNBHTHNNHHHNNNNNHNNNNTBNHHB
HNNTNBHNNNNHHTTNNHBTNNNNHNNNNTNBHTNNNBTNNTTNNTNHNBNNBHTHHTNBHNBBTHNTHHTNNNNNNHNTBNNBBTNBHTTNNHNTTNNN
NNTNTNTHNNNNTTNTTNBBNNHHNNNNNHTNNHNTNTNTNNHHTTNTNNNNBHNHNNNTNNNTNBTNNTTHNHHNNNNHNNNTNNBNNHBNNTBNHBNB
NNNNNNTNTBNNTHNTBNNNNNTNNNNNNNTHNNNHTNNTHHHNNNTTBTTNHTNNHNTHNNTBBHHTNTNHNNTNNTTBNTHNNTNBHNHNNNNNBHBN
NHNTBBNHBTNNNNBNNBNTHTNTBNHNNNHNNNHBHTBNNNNHTNNBTHNBHNNHNNTBHNNHNNNTBBBBNHHTTHNNHTTTNTHTHTTNHHHBHBNB
HNNNTHNNNBNNHNNHNTBNNHNNNNTHBNTHBHNNBNBNNBHTNBNHNTBHNBTBNBTNNNHNNNNTTNTBBTNNHNNHTNHNHTNHTNTHNNNHBTNT
BNBTNTBBNBNHBTTTTNHBNTHNBTBNNBNNNBNHBNNNTNTNNTTNNTTNTNNTTTHBNTHNNNTNNHBNHHBTNNTTNNHTHNTHBTTHNHBNNHNN
BNTNNNHNNHNBNTNNHNNNHNTBHBBHNNNNNHBTHHTHTNTHTTHHNTNNTNBTHNNNNHNHNNNNNNBNNHNTBNTHNBNBBNNBNNTTNTNTNHHB
TTHBHNNNNNNNHHHNNNHNNNNNNNNNNTNTNTNBTTNNNNNNBHTTNNNHBTNTNNNNNNNHNBNNTBHNNNNBNNNTBNHNNNNTNNNHNTNTHNHN
TNBHNNNHBBTNNBBHNBNNNNNNNNHNTNHNTNNNNNNTHTNTBHHBNNNBBNNBNNNNNHTNNTNNTNHHNHHTHNNNBHTHHBTHNNTTNNNNTBNN
TNTNTTNHTNTNTHNHNNHNNTTNNNNHHBNNTBNNHNNNHBHNBNBNBNBNNNBNTNHBNBHNNHNNTTNTNTNHNNNNTBHBHNHHBNNBTNTTTHHB
NTHHNNHNTNNTTHTNHTNNHNBNTNNNNHNNNHTTNTNNTTBNTNNHBNNNTNTNTNBBTNNNTHBTTNTNNTNTNNNNNNBNHTNNTNNBNTNHNTTN
TBTNHHNNNNNBNTHHHBNTNNTNBTNNNNNNNNTBTNTNNNNHNHHNHNNNNBTTNTTNNNNNNNNTBNTBNNHBHTNNBTTTHNTHNNNNHNBTNNBT
HNHNHTNTNNTNHHNTTHNNNNBTHTNTTHNNNHNHBNHNTBBNNNNNHNNNNHNTTTBNNNBTHNNTNBHTNHHTTHHNNBHNTHNBNNBHTNBNNTTN
NBNNNBTNNNNHHNTNBNHHNTHNNHBTHHNTNBTHBNHNHHNHNTHNBNTNNNNHTNNTNNNTHNTNHNTNNNHNNBTHNBNNNHNNNNNNBNBTNBTT
NNNNNNNTHHNNNHTNNHHNNHNTNTTBBHHTNBBTNNTBNNNNHTNTNNNNNNNNNNHNNNNNNNBNBNHNNTNNHTBBBBNNNNNTNNNHTNNNTHNT
TTHNNHHNBNTNHNTTHBHNNBNNNHNTHNTNTNTHNNNTHTNHNHNTNBHNNNBNNNHHTTTBNNHNHNNNNNNHNNNHNBTNNBNHNHHHTNTNNNNT
HBTHNNNHBHBNNHTTNHNNHNTNHTNNNNNNNNTNBHBNNTNHNNNTHBNTTBNTBNBNHTNNNNTNNBTNNNHNTNNNNNNBNBHTNTBNNTNTBTNN
NTBBNNTNNHBTNNHNNNNBNNHTNHNNNNHTTTTNNNTNBTHHTNNTHNNNNHTNTHNTHHNNNHBHHNNHNNNHHBTHNNNHHNTTNBHHNBNHTNBB
NTBNNTNTHNBHNNNTNTTBHTHTNNNNNTHNNNBBHNBHTNTTHTTBNNBNNNNNNNBNNBNTNTNTNNNNNNHNNTHNNNNTHBNTNNTNNNNTNNNN
HNNTHNNTNHNBNNTHBNNNTTNNNNNNNNTHTNNTNNNHNBTTTNHHNHHBNNNNHNNTNTBNBHNNNHBNHBNBTTNTNBBHNBHTTTNNHNTNHTTN
NTHNNNBHNNTBNNNTNHNTHTNNBTNNNTHTBTBNBTNNHHNNBNBNTNHTNTHNNNNTHNNHHBNTTHHNNNNNNNNNHHNNNTTNNHBNNNHNBHHT
