BNNNNNHNTNNBBHBHNNTNBTHNNHBTNHHNTNNTNBNHNNTHNNNNNHNNNNNHHHNNBNTNNBNNTBNNTNNTHNNNNNNNHNBBNTNBNNTTNBHN
NBHHNNNNNHTTTNTNNNNTNHNNNHTNNHNTNNNHNTNNHHHNNNTTNHTBNTBHNTTNNNHHTBHHNHNNNNNBTNBBBNNTNHNTHNTHNBNNTBHN
TNHNNHBNBTBNTNTTBHNHHBTNBHNHNNTNHTNBTNBNNNNNNTTHTBTHHNTNBHTHNNHNNNNNBTHTBNHTTNNNNTNTBHNNNNHNNHTHNTNH
TNTNNNNTNNNNHNNNNNNNHNNTNHTHTNTNTHNHHNHNTNNHNNNBHNHHNNTTNNNBNHNTNHTNNTTNNHNHNBNHNNNNBTTNNHTNBNBBBHNN
NNTHTNHNHNTHTTHNTNNTTTHTNHHNHNNBHHTNHNHHNNTBNNHBHNNNNTHBHHBHHNHNNHTHHHBNBNHNNHNNNNNNTHNNTNNNNNNNTNHH
NNTNNNNNNTTHNHHTTNTNTNNNHHNNBNBTNBNHTTNHNHHBNNBNNNNBNNBHNHBTHBBTTTNHNHHTHNHNNNNNHNNNBNNHNBTHNHNTHNHH
NBNHNTTBNHTNTTNNNHHBTNTTNBNNNTTHNNNNTTNNNHNNBBNTNNNNNHNHTNTNHNHNTHTNHTHTHNNTNNTBNNNTBTNHNHNNNNNNNHTH
THHNNTHNTNHNHNHNTTBNNHNNNNNNHNNTHNTTNNTNNNNNHTNTNNTBNTBNTHNNNTNNBNBHNNNNNNNTNNNNTTNNNNBHNHTTNTNNNNNN
BNNNTNBNHHBBBNBNTHHNHBNNHNNNNNNTTHHBHNHBNHBNTHNTTTNHTNTNHNBNNHNHHNNNNBNTTNBNTBNNNHNBNNNNNTHNTHTNNNTH
TTTBNNNNNHNHNTTNTNBHNNBHNNNNTBHHNTNNNNNNNBBBHNNNHNBTNNNHTNHTTHNNBHHNTBNNNNNHHTNTNNHNNNHHNTTNTNHNHNNT
NTTTTNNBBNHTNHTBNNNTTHNTBTHTHNTHHNHNNBNHTTHBTNNTTTNNHNNTTNHNTNHNNTHHHTBTHHNNBNNNTBNNBNBTNBNHNTNBNHNN
NBTNNBNHNTHHNNNNTHNHTNHBBBHTHHNHBNBBBNTHNNNBTNNTHNHNBHNTNNBTNNNBNTNTNHNTNBBNTNTNTBNTBHHTHHTNTNHNBNNN
HNTTNBNTNTHTNBNTBNNNTNTHHNHNNNTBTTNNTNBNNNNHNNNHNNHNHNHBTHNBNHHTTHBNTNNNHHNHTNNHNBTHBNNNHTBNTNBHNHHH
NTHHHNNHNTNTTBTNNHBHBBTTTBNNHNNNNNHHNNBNNNBTNNBHBNNNBHNHHTHNNHTNHNNNHBHTTTTTNTTNNTBNBTNNHNTTNTBHBNTN
NNNNTHNNBNNNHNBHNTHNBTTHNNTNNHNNTNNNBBTHNNNBNNTNNNTHHTHHNNTNNTNNTBNTNNTHNNNTHNHHNNNTHHHHNTNHNNNNNTNT
HHNNNNHBNNNBHBHNBHTBTNHHTBHHNNNHHNNNNBNNHNBTTTBTTNHNNNHHNTNNHBBNNTTNNNHNNTNBNBHNNTHNHHTNHTBNTHNNNHTH
HNBNNTNNNNNTHNNTNHTTBTNNBHHNNHNTNNTBHHNTBHHNNHNNNNNNNHNNNBTTHBNNHHTNNNNTTHHNNNNHNHTNTNNTNNBBNBNNTTNT
BHTHNNNNHNTNNNHNNBTHNBNNNHTNTNTNHNBHNBNTHNHBNNNNNNNNNTNTNHNNHNBNBHNTHHNHNBTNNBHNTTNHTTHNTNNTNTTNTNNN
NTNTTTNNBHTHNTBHNHNBNTTHNNNNTTNNNNHNHNBBTTNTNNHHNBNNNHNTTNNNNTNNNNNTHNNNNTTHBNTNNTHHNNNNBNTTNBNHTTHH
NTTNBHHNTNNTNTNTTHNHTNHHTNNBTNNNNTNNNNTNNNNHHHNTNTTNNNNNNNNHBBNTNNHNNNNNBNHNNBNTNNHNTTNNNNNNNTHBNHTN
HTNNNNTTNNHNNNNNTTNNHHTTHNHBNHHHTTNHTHTNNNNNTNNNNHNHNNBNHNHNNTNNBBBNNNNNHNNTHNNNNNTBTNNNBNNNNNNNBBHN
NTNHHTNBHNHHHNHNHNNNNHBBHNNNNNTTNNNNNNNHTNNHNTNNHNHNNNNTNHBHNNNNTNTNBNTNTHNHBNNTNNTBNBNNNNNNNTNBNHBH
NTNNTNNNBNNTNHHHNNNBNNBNNHTTNBNBNNHTNNNTNNBNNTNBNNNNNTHNTTNNNTNNNBBNHNHNHNTHHTHNNTTNHNNNNNHBNTNNTNBN
NNNNTNTNNHBTTNHHHNNNNNNTNNTTNTNHNNNTTHTHBNTBBTNNNTNNHNHNTBHHHHNTNHTNNNNBTBBHNNNNHHNBNTNNNBBNBTBNNNTN
NHNTTNBNNNNNNHNNBTNHNHNTNNTHNNNHBTBHNHNHBNNNNNNBBHNTNBNNTNHTTNNBTTNNNNTHNTTHNTNNTNBBTNBBNNBNNNTNNHNN
HNHBNNTHNBNTNNNBHHNNBNNHHNNNNBNNTTNTHNTNNBNNNNNNNNNNHNHNNTBHTNNTNTNHNHNHHNTNBHNNHTNNBTNNHBNTHHHBNTNN
HNTNHNHNNHBNHTNNNTTNHBNHNTNNNNNNNNTBTHBNTHNNNHBNHHNTHNTNHNNBHNNNTNNHNHHTNNNNNBTBTNNHNNNNNHHNTNHBBNNN
NNHNNBNBNHNTNHNNBTNBTTNHNNBNBHHNTHNNNNNNNTHNTHNBNNNHNNTTHNNNNNHNNNNTHHNNNTTHTTNNTNNNHHTTTNTNTHTNBNNN
HNNNBNTHTNNBBTNTNNTNNBNTHNHNNNHTNNTHNHNNHHNTTNTNNHTHHTNNNTHHNNNNTHTNNTNNHNNNTTHTHNNNHHBBTBNNNTNBNNNN
BHHNNHNNNNTTBNNTTTNHNNNNNNNNNNTNNNTTNNHTHHNNHNNHTHHBNBHTBTHNNNNNBNBHNNNTHNNNTNTBHTNNHBTTNNNTNNNHNNTN
BNTNNNHTBNNNNBTTNNTNNBNNNNHNTNNTNHNTTTHTNTHHNTNNHBNHNTNBNHNNNNTBNTHNTNHHNBNNNHTHNNNNNNNBNHTHTNNBNNTN
TBNNNNNNHTBTBTNBNHBNNTHNNNNHHNNNTBHNBTNBBHTBHBHBNNTNNNNNHTHNNBTNNTTNHNBNNBHNNTNHBNTHHTBHHNNNBNNTNNNN
HNHNNTNNHNBNNNNHNBHNNHNHNHNTNNNNTHNNNNHNBHNNNHNNNNNTNNNHNNTNTNNTTNNNNNTNNNTNNNHNNTBHNNNNBTNTHNTNNNNN
NNHNTTNTNNTHHNNNNNNNNNTNNBHNNNBBNTHBNBNTTBNBHNNBNNNTHBTTTBTBNNNNNTTNNNNHNTHBHHNNHNNBHBNNHHNBTNNNNNNB
NNNBNNNBNTHHTHNBNHHBNNHNNBTNHNNHNNNHNTNNBHNNBBNNTNTHNBHNNTHHTHNNHTNNNNBTTNHNNNNTNHNNHHHTTNHNNHNTBNTN
NNNNHNNBHNNTNNTNNNTNTNTHNNTTNHBHNNNNNHBNNBHBBNNTHHHTNHNTTNTHNTTHBBHNNTNNNNHHNNNNHTNHNHNTNNBNBNTNHHNN
TNNNBBNNNNTNTNHNNNTNTBNNNHHNBTHNNHNNNHTNNTTNNBNNHHHNHHTHNNTTNHNNNBNNHTNNBHNBHNNNNNNNNNNTNHNNNHHNNHHT
NNNBTNTNNBTTHNNNNNTTHNNNTNHNNTNNTHHNNTNHNNNTNNTNHNNBNBNHTHNNNNNNNNTNHNNNTNTNNTHBNTHNBNHNNTHBTHNNNTHT
NTTNTNNNNBHNBBNTHBNTBTNBNTNTNTHHTHNNNNHNNTHTBTHNBNBTBHNHNBNTNBNNNBNHNNHTNNBNNNHHNTNTNBTBBTNTNBNTHNNN
HTNNNTTNBNBNHTNHNNBTNNNNTHNHHNTHTNBHHTNNTNNNNTTNHBNHNHNNTBTNHHNHHNNHTHHNNNNBTNBNNTNNBNNNHHHNNNNNHNNN
NNNHHNNNBTTNNBNNNTHNNNHTNNTNNNNNHNNHNNNNTNNNTNNNNNTTHNNNHNNNNNTNHNNNHTTNTNNBNBTTHNTNNBNNNNNNBHNNNHNN
HNHTTHTNNTNTNNHNNNTNBNNTHTNTHBNNHNNNNTNNHNBHNBNBHNNTNNNTNBNNTBNNNTHNTNHNHTTHTTNHNHNNNTTBHNNTHHBHBNBT
NNNNNNNNNHHBNNNHHNNBNBNNHNBHNNNNNHHBNTTNNNNNNNNNHNHBNBTNNBNTNNNNNHHNTNNHNNNNNNNTNNHHNHBNHNNHHNHNTNNH
BTBNHNTNHHNNNNHNNNBBHTBNNNNHNTHTTNNNTHHNTNNHNHBNNTNNHNHNNNTBBNNNHTNHNBNNTTHNNNNTNHTNTNNNNHTTNTNNNTNH
TNNHTTHTTTNNNTTNNNNTBNNNNBTNNHTTBHBNTNHNNNTNTHNHTNBNNHNBNBNNTHNNNTTNHTNHNNTNNHTHHTNHTHNHTNHNNHNNNNBN
NTNNHNNNNNHBBHHNNNBNBNNNHNTNBNNTNNTNHNHNNTBTNTNNBNNNHNTNNTNNNNNBTHNNNHTTNNNNNHTTNTNBNTHNBTBNTNNTTTHN
THBNHHNNNBNNNNNNNHNNNNTHNNNTHNHTTTNBBHNNBBBHNNHNNNNNNNNNTNNNBTHNNNNTNHBNNHNNNBNBHNNNNNNNHBTNHHNHNTNN
NNHNHNBNNNNBTNBTTHNHBHTNNTBNBHNHNTHNNNTTNBTHTTNNNNHNNNHHHTBNNTNTNTTNNTBTHBHHBTNTNTNNNNTNHNNNTTHNNHBN
TTNTTHTHNTNHHBBNNNTTNNTNNTNBNBNTNNHNTNNHNHBHNHNNNNNTBTNNHNTNTHNNNNNHNNBNHHTBNTNNNHHTNNTHNTNNTTNNHHHN
TNHNBHNHBNNNBNTNBNNNTHNNBTHBNHNNHNNHNHNNHHNNHNHNNHNNNNNHNNNTNNNHHTNBNNNBNBNBTHNNHHTNHNNNNNHNNHNNNNTN
NNNNHHNHNNNNTTNNHNBNNNHHNNNNNNNBNTHNBNTTHHNNHNNTTNNTBBNNNHNNHNTNBBTTNBTNBTNTTNNBNNNTBNNNHNHNBHHTNHNT
NNHTNTNHBHBHNTNNHTNTNHNHNHNHHNNHTNHTNHNTTNNHTTHHBTNHNTBBNNBNTNNNNNTNNTTNNNNNNBNTHBBNHNNBNTHNTNNNTHNN
THNHNTBHTNTNNTTHHHNNNBHHHNHHNBNNBNNBNNTTNTBNNNNNNNNNNNNNNNNTNNBNHNNNTTNNNTHNHNHNHNBTHHNTNHNNNNHNNHHT
NNTNHHNNHNNHBNHNNBNTNNNHTHNHHTNNHBTTBNHNHNNNNBNTNNNBBBBHNNTHNNHTTHBNHHNNNBNNTNBNBBTTNNNNBNNNNHTTNNNN
NNNNHTHNBTHTNNNNTNNNBHHHNBNNNNTTNHNTNNBBNTHNHHTHTHNTNNHNTTNNTNBTNNNNTBHTTBHTNNTNHTBNTNBHHTNNNNNNNNTT
NNBTNNHTNHBNHNNTNHNTNHNHHNNHBTTNBNBTNTBNBHHNTTHNBNNNTNTNNTHHNNNHNHNNTBTHHBNHNHTHNNNBHNHNNBNTNNNHHNNH
HTHNNNTNTBTTNTHNTTNTTNBHHNNHNNBBNTNBNNHNBHNHNHNTTBNNNNNHNTNHBBNBTNBNNTNHNNBHNHNHNTTTTNBHNNTNNNNNHNNN
HBNNNNNNNHTHNBNHNTNNNNTNNHNHNHNNNHBNTHTTTNHTTNBHBNHNNTNNBNNNTHBTHHBNTNNTNNNNNNNNHHHNHTNBNBBHHBNNNHNN
NHHTHTNNNNNHHHHNHHNTTNBHNNNTNHHHNTBHNNNNNNHHBHTNNNTTHNBTBTNNHNNTHNTBNHBTNNTBNTNBHNNNNNNNHNNTHNNNTNNN
NBBNNNTHHNNTNNHNTHBHTNNNNNTNNHNNNNNBHTNNNNNNNTNNTHHNNNHNNHHNNNTNNNNNBTNNNTBBTBTHNNBNNNHTBBNNNHHNNTNN
NNTHNHTNNHBNHHTNTHNTTHNNNNHTNHBNNTTNNNHTBNNNNNNNNNHNHBNHNNNNBHNNHHTNTTHNTTNTHNHHHHTTTNNTNTTNHNHNNHNT
NHNNHNNNNNNNTNTTBHTTNHHNNTHNNTBHHNBTNTNTNNHNTNTNNNNNTNTNTNNNNHNBNHNTTTTTNBHBNHNNNHTTNNNNNHNBTNNTNNHT
HNTHNNNTTNTHHTNBTTBTNNNNTNNNNNNHTHNNBNNTHTHTNBHTBTHHBNNNBNHNNNNTTBNNNHNTTNNHTHNTNTNNBNNNHBNTHNHTHHNN
HNNTHHHNHHNHTHNNHNNNNNNNNNHHNNNNHNNNTTHTBBNNNNBNTNNNHHNNHTNHNNNNTNHHNNHNNNNNHNTTNTNHNHNHNHBTBTNBNNTN
NNTNNNNNNTNTNNNNNNTTHTHTNNNBNNHBHNNNNTNNBNNHBHNNNNNNNBHTNBNTHTNNHHBHNNNNTNTTTNTHNBNNNNHNNNNNTTBNNNNN
TNNTNHTTTBNNBHHNNHNNNBHTNNHNNNNNNHHBNBBNHNNNHBNHNHNNHNHNHNBNNNBHNBTNNNNBHHHTTTNNNTHTNTHNNTTTHNHBNNBT
NHHNTNBHTNNTNNNHHNNTBBTBNNBHNNNNTNTNBNBNNTHTNHNHNNNHTNNNTNHNNBHTTNNNNHNNHNNNNNNNNNTNHNTTBHNNBNNNNNTH
HNNTBHTNTHTNTNBNNNBNNHNBHHNNHHNNNHNNTNNBTNTBNNHNNNBNHBHTNTNNBNNNNTHHHHTHHNNNNHNHNNTTHNNTNNNHTNTHHNNN
TNBNNNNNNBBNNTNTBHBNTBNTNHTNNTHNTNHHNHNNNNNNTBHHNHHNTNTTNNTNTTNNHNNNHHNTNTHTNNTNHNTTBNTNBNHHNNNNNTNN
NTHNBTBHNNHHNNNNTNNHHHTNNBHNNNNNNNNHHNTHNNTNHTNNNBNHNNTBHHBNTHNNTTTNHTHNBNNNNHNNNTNNHNTBHNTNHNHHBBNT
NNNBBBHHBNNNHNNNNBHBNTNNHHNNHTNNNNBNNNBNBBHBNHNBNNTTNNBNHNNNNBBTNNNTTTHNHNTTNBNNBBNNNNNNBNNBNNHNNTNN
HTHHHNTHNNHNNNHBHNHNTNTNTHHNNHNNHNHNNHNNNNHNHNNTNNNHHHNHNNNNNNHNNBHBNTNNHNNBNBHNHNBHNHTNNNBHTTNNNHNN
NTNNNNBNHNNHNNNNHTNTNHNBHBTHTBNNTNTNBNTNNNHHNNNNTNHNBHTTNTNNBNNNBNNNTTNHNBNNHHBNHNHNNTNHNHHNBTNNNHHN
NHHHNNNTHNNBNBNTNHNTNTNBTNHTNTBHHNTNTHTNNNNTNNNTNNNHNHNNNNNNNNBNNNHNTNHNBNNNTNNNTHNNNNNHHNTNNBHNNNTN
NNBNTHNHTTBNBBTBNNNHNTBNNHHNHHNNNNNNHNHNNNNTHTBHTHTNHNTTNNNNNBHBHNTHHHNNNNHHNTNNNNNTNTNNNHBHNNTNHTTH
HHNTNTHNTHNNNHNNHBNHTHNNNNNBNTHNNNNTTNNTTNHNTHTHNHTHBBBHNNNNBNHTNHNNNHTTNHNTNNNTTNNBBNHNNNNNHNTTTHNN
THNBTNNNTNNNHNNNHHTTHTHBTNHBNNNTNTHNNNTNNNNHNHNNTTTNNNTNNNNNBBTNNNNNHTTNNNTBNNTHHTHNTNTNTHTBHNNNNNTT
TNHNTTNNHNTNNNHNHNNTNTTHTNTNNHHTHBNTHNHNTNNNBNTHNNTNTNNNTNHTNNTHBNTNNBTHNNNNHBHNNBTNHHNHTNTNNNNBNHBH
TNBHNBNTTNTNNBNBNBNBNTTTTNNNNBNNNNNHNTNNBNNNNNNHBTNHBBTHNNTHNTNTNBHNTHHBNHHBNNNNNNNNNTTNHNTHNNTTHNNN
HHNNNNBTNTTNNNNTHNNNBBNNTHHHTNNNNHNHHNBHTTTNNBTHNBHHNTNNNNHNHNHTNNTHNBNNNTNNNTHHNBHTHHNHTHNNNNHHNNTB
HNHHHNTNTBHNHNNHTNNNHHNTNHNNNHNHTBNBNHHTBTTNNTHNNHNTHTBTHHTNNNHNBBNHNBNTTTNHTNTTNNBNTHHNTHNTNNTNNNNN
NHHNTNTNNNTNHNTTBHNTBNNNBNNNTNHNHNBNNNHNNTNNTBNNHHTTNNTTHNBNTNNNNHHNNTBNNHNTTNTNNNNBNTNNNBHHNTBNNTNN
TNNNNNNBNNNTNNHNTNBNNNNNTTTHNNBNHHHNNNHNNBTNHNBHTBHTTNNBNHNTNNNBBTNNTNTTHTNTHHNNTBNNNTTNNHTTNNNTNNTT
BNTNTTNBNNNHHHBBNNTTBHHTHTHHHHNBTNBHNBHHHNNNHNBNNHNNNTNTHTHBNHHTNNHNTTNNNTNBHTHNNHNNNTTNNNNNNNHNNNBH
BHNNNTNNNBHNBNNNNNHNTTNNBNNHTBBBBHHNTNHHHNTNBNNNHHTNNNTNTNHNTNTTBHHHHNNHHNHHHTNHNTNNHHNTNTBNNHNNNTTH
NHTNHHNTTNTHHTNBHHNTNHHBBNNNTNNTNHBNNNBHNNHNHTTBTNNBNTNBBNHNHNTTNNHNTHNTBBBBNHHBTHBTHNNTBHHNTNTNHTNN
NNHTNHTNBNTHHTNHNHBNTTNNNBNNHTHHHNHHNNNNNNNHNNNNNNHHHNNHTHNNNHHNNNHBNNTNBNNHNNNNTNTNNBNNTHNBHHNHBTNH
NBNNNTTNHNNTNBNNNBTNHNNHHNNNNTHNNNHNHTNNNBHBNHNNNNTTNTNBTHNNBHHHTTHNTBBNBHNHNBNNNNHNTNNBNNHNNNNNNTNH
HHHTNTNNNTTNHTHHBTNBTNNNTNNNNTBNTTHTNTNNHHTHNNBBNHTNTNNNTTBNNNNNHNNNHNNNNHNBNTNTNNBNNHBTHNNNHTBHTBBN
NNNHNNNNNNNBNNBNNNNTHNHHNNBNTNTBHNHHNNHBHNNNNTHNNBHNBNTTBHTHNNNNHNNNHNBTNHHHTNHTHBNHNTHTNNHBHBNBBTNB
BNBHBHNNNTNTHNNNHHBTBNTHBTNTNBNHBNNHHNNBTHTNHHNTNTTNNBBHNTNNNTTNHHNTTNNNNNNNNNNHNTHTNHNTNNNHHBNNTNHN
NNNNHTHTHTNHNTNBHBHTNTNHNBNTNTNNTTHTBNNNTBNNTNNTTBBNNBHTHTNNHNHHNHNTHNNNTNNNNHNBNHNHHNNTBNNHNTNBTNHN
NBBBNTNNHBNNNTNHTNNTTTNTTTNBHTHHTNBHBNHNNTTHNNBNNNNTHHTNNNHNNNNNNBTHNHNTHNTNBNTHTNNNNHNTNNNHTNNNBHBN
TNTNTTNNHTHHTNNBTTNHNHBNNBHHHHHHTTNNNNNNHNTHNBNNNHBNHNNHTNTTNNNHBNHNHNTNTNHNNNNNHTNHHNNHNNHTBNHNNTHB
NHHNNNNTNNHBTHTTNTTNBTNBNTTBNNNNTHHNTTNHNNHTNHNNNNNNNTHNNNHNBNBNNNNNHHNBHNNTNTNHNTNBNBNHHNNTTNNHTNTN
HHNNTHHHHNHBTNBTHNNNNHTNHHHNNBNNTNHHNHHTTNTNHNNHNHHTNHTHTBNNNNTBNTNNNBTNTNNNTNNHNTNNNNNNHBBTBBNNNHTT
NNNTNNBBNHHNTNTHHNNHNNTTBNNTNBNNTNNBHNNTTNNNTBNHNTNNNNNNTBTNBNNBNNNNNTNTNHBNHNHNNHNHNHHTBBNNTNTHTHTT
TNNNHNBTNTBBNHHNNHHTBTTNHHTHNNTHNNTNTBTNHNBNNHNNHTBNNNNBNBNTTNHNNNHNTTNHTNHNNBTNNHBNNHNBTBHNBTHHHNTT
TNNNNNNTNBHNHNNNNHNNNTBHTNNBNBBBNNNNBNHNHBNBTTNHNTNHHTNHHHNNNHNNHNHNNTNNHBNNNNHHNNNBNHHTNTNNNHNNNTTT
HTNNTTNHNHNNNNNHNTHHNHNNBTNNNNTTNNNBNNHNTHNNTTNTHNTTNNNNHNNBBNHNTTNNBNHNNBNNTTHNHTNBHHNNTNNTNTTNHTNT
