NNTBHNTTBNBTHTHHBBTNNTNNTNNHNTHTNNNHBNTNBNNNNHHHBHNNBNNNNNNNNNNNHNBTNNTNHHNTTNNTTBNTNNBNNNNNBBNBTTHT
HTNTNNNNNHTNNNTHTBNNNHNTHNHHHNTHNNNBTNNTTTNNHHHNTNNHTHNHBNHHNNTNTNBNHBBNNNNBNNNTTNTNTTTHNNNTNNBNNNNN
BNNHTNNBHNHNHTBNNNNNBNTNNNHBTTNBBTNHNTBTNTBNNNBTBBNTTNNHTNNHNNNTBNHNNNNBBHTTBHNNNBTNNTNTNTNBNHNNNNNN
TNHNTHHNNNHNNNTHNHTNHBBTNNNHHHNNNTTNNHBNTNBNNNHNNTNNTNHNTNNNTHNHNHTNNHBNHNTHNNNNTTTHBHTNTBNNNNNNNNNN
NNTNNNNNNNBNHTTHNTBHNBHNBHNNHBHNNTNNNTNNNNNTNHHNHNBNNHTNNNNTNNHNTNNNHNNNNHNTNNHNBNNBBTTTHHHHNNNHNBBT
HNHNBTNHNTHNTHNTBTBTNNNHNTNTNTNBTNBTNNTBNNHHTNNTNTTNHTNHNBBNBNNTNNNTTNNHNNHNNNNNTHHNNNTBBBHTNNNNNNBN
NTNBHNNNHTTTNNBTNHNTNHNBNNTHNHNTHBBTHHHNTHHNTTHHTBNNBNTBBBNTNHNHTHTHNHTTHNTBHNNNNBHNHNTHTNTNTNNHNBNN
NNNHNTNTBNNNNHNHNHNNNTHTTNHTNTNBTBNNTTNNNBNNHTBHNBNHNNBNHHNNTHNTHNNHNHBTNNNTNHBNNNTTNNTNBNTNNNHNHTTT
NHTTNNBNTTNNNTNHNTTNNHNBNHNNHTNNNNNNHHTNNNBBHNNHNNHNNNTHNNHNBNBHNHNHTHNHTNNHNHNHNNNTNTNBNNNNTNBTNHNN
THNBTBBNNNTTNNHNHTHBNHHNNNBTBBTNNHTNTHNTNNBNBHNNNNBNTNNNNTHBNHBNHNNHHTNNNHNTNTBNNBBNNNTBHNHTTNTNNTNN
NTTBHNNNNHNTNNNTNBTNNTTTBNHNHHNHNNNHNNBNNNBTHBNHHNNNNTBNNHNNNTNBBHNBNNHTNNNTNTNNNTNBHNNNNNHNNBHNNNTH
NNHTNBTNHNBBNHNBHTHNNTHNNHNNNNNHBNHTNNHNNTHBTHTNNBHBNNHHHNTNTNTTNTNNTNHHHNNHTTHNBNNHNHTHHHTHNNNBBTTN
TBNNTBNHNNNTTNNHTNNHNTNBHTHNTHHHHNHNNNNNBHNHTTHHNHNHHBNTTHTBNNBHBNNNNBNNHNNNHTNHTNBNTTNNNNHNNNTNNNNN
NTNHTTNNHNNBNTNBHNHNNNNTNTHNHTTTNTBBNNNNNNTNHTNTNTNNNNBNNHNTTTNTHTBTNBTNNNTNTNHTNNHBNHNNNTHNNNTNBNBN
NNNTHHNHNTHNNBNHTNTHBTTNBNTHHBTTNTNNNTTNHNTBNNNTHNNNHNHTNNNNNNNBNNNTBTBHNTTNNBNBNTNHNNTBHNNHBBNNNTNN
NNNTNNBTBNTNHNNTHNBNBHNHHTNTNHNTHNNBNHNNHBHTHHNBNTNTNTHBNHBNNNNTNTNTBTNNTHNTHNNNHBBNHNBHNTBHNBNNNNNN
NHTTNNNNBNNNNTBNHHNBNNNTBNNNTBHNNBNNTHNNNTNBNHBTNBHNNNNNNTNTTNBTNNBTNTTNNNNNBNHBHTTNNTNBBNHNNHNNHNNN
NNNTHNNHNNNNNBHHNNNNNNHTNHNHNNHTTHBHTTHTNHHNTNTNHNBNTHHHHNNNTHNHNNNBNHTTNNNNNNNTHHTHNNNTNNNNHBNTNNHN
NNNHNNNHNNHTHNNNNNNHTBHTHTNNTTNHNNTNHNHNHNBNTHNHNTNNNNTNNTNNNNNTNTNBNNNBNHHNHTNTBTTTTHNHNNTNNNBNHTNN
TTTNBHHNTNHNNNNTNTTHNNNBTNTHNNNNNNNHNTNNBTNNHNNTNNTTNNNNHNTNNBBBHNNHNHNHNTNNNNHTHNHTNNTNBNNNHNTTNTNN
HNTNHHTBNHNHNTHNTHTTHTTHHNTHNBHTHNNHNHTNNNNBNNHNTHNHTNNHNNNNBTNHHNNTTNNNNNBNNNTBTHHHNHHHTNHNTBNNBNHN
HTNHNNNTNNBHBTTHHTNNNTNNHNNTHNNHHNHNNBNNNNNNNTNBNTHNHNHTNTHNNNNNTNNTNNTTBNNNTHNNNTNHNNHNNTNNTBNNHNTB
BNNBHNNNNNHNNNTNNNTTNTTNTHNTNNNNBNHHNHNTHNNNBNTBNNNBHHTTBTNBHNNTNNNNHTNNNTHBNHNHNNNTNTNNNHHHNTTTTNTN
NNNTTHNNHHHBBBNTNHBHTHNNHTHHHNNTHHNBHHNHNTNNNNNNNTNHNNNNNNNBHTNNHBNTNTNBTNNBNNNHNHNNHHNHHNNTNNHNNHNT
NNNBNNNNHBHHBNNNBNTHTBNNBHHNNNNHNHTNTHNNHNNHNNHNHTTTTNNNBNTBHNBHTTNNNNHTNNNNTHHBHNNNNNNNHNNHHNNNNBNB
BNNNNTBNNHNNNNNHNNHHHTBBNNNNBTNHNBTNNTNNTNTHNNNTNNHNNHNNHBNBHNHTBHNNTTTHHBNTNBNTTNNTBNNNTNHNTNHNTTNN
NNHNNTTNNHNHBNNNTNNNTNHHTTTNHNNHNNTNNTNNNHNBTNBHNTBTNNNNTNTHNNHTHNNNTNNNNNNHNNNHNTNNHNTTHTNBNNHHNNBN
THNNNTNTTNBNHNNNNNNHNTTNHNNHHTTHTNNNTTNNNNTNNNNHNNTHNNNTNHHNBBHHHHNHBNNHBTBNTHBHHHNNNNNHTNHHHTTNTBTB
BNNNNNNNTNHNNNNNNHTBNTNNNBTNHNNHNBNNHHBHTNBTBNNNNTBHHNBBTNHNNTTHNNHTNNNBNTNTNNBHHNNNTNNNBTTNTBNNTNNT
NHHTTTHNHNBHBBNNHNTHNNNNNNNHHNNHNHTHNTHNNHTBNNNTTNTNTTNNNTNTTHTBHHNHNHNTNNBHTNHNBNNNTTNBNNNNNNBNNTHN
NNBNNTNNNHTBNNTHNNNTNNTBNTTHTTNHTHTNBNBHNNHHTHNHNNTNHHHBTHHNTNNNHNNTHHBTTNNNHNNNNTNNNNTNNNNNNHNNHHNB
NNNNNHNBHNHNNTHNNTBTNBTNNNNNNHTTHTNNNHHNHNNNTNHNTNTNTHNTNHHHNNTTNTHHNNHNNTNHNNNHNNBTNNTHBTBNTNNHNNNT
NBNHHHNTNHTNNNTTBNHHNTNNTBHTNTNTNHNHBTNHNNHNTNTNBTNHTBBNTHNBTNHHNTNHNNNNNNHNTNHHTTHHTBNTTNHNNNHNNHTH
THNTTNNNHNBNBHTNNHNNNTNTHNNNTHTTNHHHBNTNHBNNBHTTNHHTHHNBTHHHNNBNBHTTTTTNTHNTTHBNNBNHNNHNNNNTNBNTTTNT
NBNNHNHNHNNHNNNNBNNNNHBTNHNHHBHTNBHTNNNNNNHNTNTHHHBNNNNTHNHTTTNNNBNTNNTTNTNNNTTHHTBBNHNNNHNHHHHBHBHT
NNNBBNNHNNNTBBNBTNHHHTTHNNTBNBNNBHBHNNNNNHTHNNNNTNNBTNNBHTHHNNBNNTNNTBNHTTNHNBHHNHNHNHNTNBTHNNNTBNNT
NNTNNTNBHHHNNNNNHNHNTNTNHNNNTNHTTHHHHNTNNHNTNNTTNHTBNNNTHNHHHTNNTNTNNTHHHNNBHNNNNHNHHNBHNHNTNNNHNNNH
NHBHTTHHNNNNNNNHHNHTTNNNHNBNBNNNNNHNTBBNTTTNTNHNTTNNTTHBTNHNTNNHHTNNNTHNNHHNHNTNNNNNNHBHTNNNNNNTNTTH
NBNBHNNBNNNNHTNNNNHBBNNTTNNNHBHNTHNNBBNNNHNNTTNTBHBNTBNNNNHNHTBHHTHHNNNNTNTNNHNTNNHNNBTNBTTHNNNHNTHT
NTNNHBNHHNNNNNTNNNHTNBHNNNTBNNHHNBTNHNNNTHBNTHNNNNNHNNBNHTBNBTTTNNBNNNNNHNTNTTHBTNTNNNTBHHNTNNNBNHNH
HNNNNHTBNNHHTNNNTNNNTNHNNHTBNTHNHNNTTNNNHNNNTNBTHTNTBHNTHNBNNNNNBNTNHNNBHNNBHHTNNTNHNHTBNTHNNHTNNTNB
HHNTNTBNNHNHNTHNTNNNNHNBNNNNNTNTNNNNBTNNTNNNBBNHTBNHNNNNHNBNBTNHNTNTTNNNNTTHTTTHTHNBNTNBTNTNBTHNBHHN
TNHNTBNTBNHNBTHNNNTNNNNNTHTNNNTHNTTHTHHNHNNNNTNBBNTNNNNHHNHHTNHNNNBNBNNNTNNHNNHNNBHNNNHHNBNBNNBHTNBH
NHNTBNNNNHNTHNHTTHHNNHNBBNBNNNBNNBNHNNHNHNNTNNHNHHNNTHNTTTTTBTTHNHHNNNHTNNTNBHNNNTNBHHNTTNHTNHNNNHHT
NHHNTHHNHTNNNNNNTNNNNHNHNTTBBHBTNNTNNNNHHBBTNNTNNHHTNNTNTHTNNTNTNBNNTHNHHTBTHHHNNTTHBTTNTTTNNNTHNNBN
HBNBNTTTNNNNHNTTTHTNNNNHHTTNTTBNNHBNNNHTBHNNNNNTNHNNNBHBBTHHNTHNHBNBTNNHTTTHNNNHNBNHNNNTTTNBNTNNNHTH
BHNNNNHNNHTHHHTTTTTNNTNBNNNHNNNTTTTTTNNTNTNBNTTNBNBNHNTNBHNHNNTHTHNTNHHHTNNHTBBHBHNTTNTHNHBNNTNTBNTB
NNNBNHBNTTNBTHNNNNNTTBHHHHHTBNNHNTNNNTHNNNHHBBNNNNNHTTTHNBNNTTNNHTTNBNBTNNNHNTNTNTNNNBTTTNNNNHNNNNTN
BNNHTBNHTNHTHHNNNHNNNTNNNNNNNNNNHTNTTNNNHBBNHTHNHNTNNNNHNTNNNTNBNBBBNTNTNNBNNTTNNNNTTNTHNBNHNNHHNNNT
TTTNNNBNTHHBNNHTHNNBHNNNTNHNBBTNHBHBHNNHNHHHNNHTNBBNNNNTTNHNBNBBTNNNNNNNNBTNNTNNHHHHNNNHTTNHHTNTNTNB
HNNHTNTBBNNTTNNTNHNNHBNTNNNNNTTHNNTNBNHBBNTBBHNTNHHHBHHBTNNNNNNHHHNTTNNNTNNBNHNNNHTNNHNNNNNNHTNTTNTN
NNNTTBBNTHNNBNTNBNNNNTNBNNNNTTTBBTNHBHHTHNTNNNNNNBNBHBHNTNNNNTNNHNNTBNNNTTBHNNNTHHTNTTHTHNNNBHNNNNTN
HNNNTBHNHNHHNHHHTHNTNNNNNHTHNNHBTHNTBNNHNBNTNTNNHNHHTTTTNNTBNNBTTNHNNNNTNBHBNNTNNNTNNNHNBHTNNNNHHNHH
TTNNTNHNNNNTHBTNNNNNTHTNNTNHBBNNBNNNHBHNNTNNHHHTNBNNNNNNTNHNNTTNTBHHNNNHNNNNNTNTHNNTTTTNTNBNNNTTTTNH
NNTNNHTNTNBHHNNHNTHTTNHNTTHTTNHTNNNHTTTTTNNNNNHHNTTHNNBNBNNHNNBTNHHNHNNNHBTHTNHNNNBNNTNTTHTNNNNTNHNN
HNNNNNTHTNTNNHNBHBNNNNNNNTNHHNTNNNNTBNNHTNTNTTHNNNNNTNTHBNTNNNHTNNBBTNHNTBTHNNTHNHNNTBNNNNTNHHTHNNNT
HTHNNNNNTTTNTNNNNHTHTNNBNNNHNNHHNNNNTTHNTNTHNBNBTNHNTNNBNNNBNNNBTBHHNNHNNNNBHNHNNNNHNHNNNHNNNTTHHTNN
NTBTHHNHNHNNBNHTHTHNTNTTBTNBTNNNNNNTHNNBHNNNTTHNHNNTNNNHNNTNBTNNNHNTNBNNNTNNTHNTNHNBHNHTNNNNTNNNNBTB
TNNNNBNHNNTBTTBHTHNTNHTNHBHNNHNHNNNTTNNNNHNTHTNBNNNNNBNNNTTNNHNBNNNHNBHNTTNNNNTTHNBNHTHNNNHNHHBBTNTN
BBTTNTNNNNNTHBHNTHTNNTBNNBNNBHNNHBNNTNTHTNNNTNNTHBTHHTNTNTNTHBTTNNNHNHNNNNHHTBNTNNNNHNNHBNNHNNNNNNTH
NNNTNHNNNTBBBHHNHTNHNHNNBTBHNNNTNBNHNNTHHNHNHNTNNTNNNNNNBNNNHHTTNNNNNNTNNNHNTHNNBBNNNTTHHNBNHTNNNNHN
BNNHNTTHHHTBTNNHNNNBBTHNTBNNNNNBNNNHBBTHNNHNHHNHTNNNBNNNTNNNHNTBTTNTNBBTNTTBHHNNHNNNNNHNTNHHNHHNTTNH
NTHBTTNNNBNTNHNNHNHNTHNNNTHTHHTHNTTNTTNNTHTTTTNHBNHNNNNNHTHBNNNBNNBNTNNNNHNBNTNTHTHHNBNNNTHNNNTHNNTN
NTHNBTNNNTNNTBNBNTTBNNNNNTHTNNTTNTNHTNNHNTNBTTNHBBHHNHTNHTHTHTTHHTNNNNTHNBNNTHHNNTHNNTTNNNNHNNNNNNHN
TNNNNHNBTNNTNNTNNHHTTNNBBNBTNNHNNTHNNNNNBNTHHHHNNTNBHHBNTHTHNNTNNNNBNNNNHNHNNNBNNTNNNBNNTNNNNNNHNNBN
NNNTHNNNTNHNNBNTNHNNNHNNTBNHNNNTTNTHNNHNNNNBHBHHHNTNNTNNNNTNNNNTNBNNTHTNHNNHTNNTHTNHTNTNBNNNHTHHNHHT
NNHNTNNNNNBNNBNHTNTHNNHTNNHNNHNNTTNNHNTNTNHNTBTNNTTNNHTNNNTBNTNNHNHHBNNNNNTNTTTNNTNHNNHNNNNNBNHNTNHH
NNTNTNBNHHHHTHHHHNNHBTNNHBNHBNNTBNNTTHTHBHNTHBTNHNHNNTNHTNNNHNBNNHNTNNNNBNNHNTNTNTBNNNNNHNNHNNBTTHBN
TNHTHNTTHHHTNHTBTNTNTBHNHNHNBNBHTTNNNNNBTTNHHNTBTTNNTNNBNTNBNTNNTTBBNNNNNHTHNBHNBNHNHNHTHHBHHNNNNHNN
NNNHHNNNHNHHNHTNTNNNBNHNTNHTHNNNBNTTTHTHTHBTTNNHTNTTHHNTTTNNNNNBNNNTHNTTNNHNBNNNNNBNNNNTTNTBNBHHHNHN
HNBTNNHTNNHTNTNNNHNHNNNHTHTHHTTHTNNNNNNNTNNNHHNBNHNNNNHTNHTNNHNTTNNHNHBTHNBNNNHHNNNNNTTNBNNNNNTHNNTN
NTNTTTHNNHTHNNNNNNHNTNTNTTNNTHNTTTNTTBTNNHHNTNHHTBHNTHTTNTHNHTNNTNNNNHNNTHNHNNTTNNNHNTHTHBTNHNNNTNTT
NHNNHNNNNNNBNHNNNBNNNNNHTNNHTHNHBNNTNNNTNNNNNNTBNNNHNNTHBTHNNHNNHNBTBNNNNNHHTTHHHHTNBTHNTNTNHTTNNNHB
NNNNNTTBNTTNNTNBTBBNNBHNNNTNHTTTNNNNNHTNHBTTTHNNHNNTTNTNNHNHNNTTTNTNNBBNNHNNNNNTNBTTHTHBNHHNHNNNHTNN
NTNBNBHNNBNNNHHNHHHNNTNHHNHNTTTNHNNNNBNNNBHNTNHNNNHNNTNNTTNNHNHNNNNHNTNBHTNNNNNNNTNBTHTNHHNNHNNTHNNH
NHNTNTHNNNHHHTNNNBHNNBHNHNHTNNNNHBNBNNHNTNTTNNTNTNNHNNNNTNTTHTNNHNHTNBHHBTNBHHHNNTNHTNNNNTNTNTNHNNTN
NNNNNHBNNTHHNNNNNBTNNNTNTHNTNTNTNHTTNTTNHNHNNTNHBBTHTHNHNNNTBNHBTNTBBNBHBTTTNNHNBHNNNTNBNTNNNNNBHNHH
HHBHNTBTBHNBNHTNNHTBTHHNNNNNNNBHTTTNTNHNHNHNTNHTNHNBNNNNNHNHTTNNNBNHTNNNHNNNBBHNNTNNNNBNNTNHNNHTNNNH
NTNNHNNNTHTNNNTNNNTNHNNNNNHHHNBHNBHNTNBNNHBBNNNTHHBNTNHNBNHNTTHNBNTNTNNNBBHNNHNBHNTTNBNNNNTTHTHNTNNH
NTNTBTNNNNBNBBNNTBNHNBNHNHNBNNTNNNTNNNHNTBNTNBNTNHBBTBNNHNHNTNTHNTNBNNHNHTBNHNTNHHTHNNNHNNNBHNNTNBNN
NHNTNNNTNNNNBTNHHNNBBNHBHNTTNNHNNNNBTNBHHNNNHTNNTBNNNTHNNTNHTBHTNNNHHHHNHBNNNNNNBNBNBTHTNTHTTNNNHTTT
BBNNHHNNTHBHNBHNTNNNNNNHNHHNHHHNHNNNNNNNTHTNNHNNTBNTNTNNNNTNTHNHNNNTNBNNNNBNNNHBTTNHNHNBNNNNHHNTHHNN
TNNTHTHHNNNNTTTNTNNNBNNNNHBHTHNBHBNNNTNHHNTTTNHNBNHNTBNNTNTNBBNBHTBTNNBHNNHTNNTTHNNNNNNTNNNTHTNHTHNH
THBHHHNTNNNHNTNNTNTNHNHNNNBBTNTBNHNHNNNNNTNNNNHNNBNNNNTTNHNNTHHHNNNNTTNNBNTNNBNNHTTTNBNTNBNHNNNNNNHN
NNNTNNBNHNHNNHNNNTNNNNTNNNHNHTNTNNNNNNBNTHNHNTNHHHNNNNNNNNHNNNNHNNNNTBHNNTHNNNHNHBTHNTHBNTBTNNBHHNTN
THHTNNBBHNBNNHNTNNBHNTTNBNNHTTNTNBNHTNTTTNNBNHTNBTTHHBTBBNNNBTNTNNTNNTNNNHNBNNTHTNHTNHHBNHNTNTNBHTNN
TTBTNHHHNNBTBNNTNNTNNNNTNHNNNNHNTNBHTNNNHNTNNTNNHNTBNNNNHHBNNTNTTTTNNTNTNTNNTNTHNNNNNNTTNTNHNNNHNNTN
TNTNNNNNNHTTBHNTHNTNTNNHBNNHTTTNBTNBBHNNTNBNTNBHNTHHHNNHNNHNNTNNTNNNHNNBNHNBNNNBHNTNHNNNHTNNHNTNNNHH
NNBNNNNHBNBNNHHTNNNNNNNBNNBNNTNNNHNTNHBNNNNTNNNNTNTTTNTNHNHHNNBNBNTHTTNNTNBHNHHHNTTNHHHBHBNNBNNTHNHH
TTTTHNHNHNNTTNHNTHTNNNNNNNNNTBTNHHNNHTNHTTNNHHNBNTTTTBBNTNNNNNNTTNHNHNTNTHNNTNNNTNNNNNTNHHBNTNTNNHBT
TNNNNNNTNNNTHBNNHNTHHNNTBNNNHNTNNHBNTNTHTHNNTNBBNTTHHNNNHNHHTNTNHBBNHTNNBNHBNHNHNTBNBHNHNNNTHTTHNNNN
HNNBNTNHHNHTTNBNTHNNTHNTTBNNNNNBBNNHNNHBHNNNHBTHNBHNTTTHBNTNBTHNNBNNHNNNNNNNHTNNNHTHNNNBHNTHNBNTBNHN
NHNBNNTHNNNNNNNNHNTHNNNTTNNTTTNNNNNTBTHTNTHBNNNNNNNHHNTHNNBTBNTTNTHHNNBHTTNHNTNHNNNNHBHTNNNNTTTTHNBN
HBTNHNHNHTNHHNHHNTHHNTNHHNBNBNNNBNTHTNNNHHTNNNNNBNNNNTNNNBNNBNTNHNNHNHNTHTNBNNHHHBHNHTNNTNTTNNNTTNBH
NTHTNNNNNNHBHNNNTNTNTBBNTBNBTNTNBNTTNNNNHNTBNNHNNHTNNNNBNNBBNBNBHTNHNTNTNBHNTNTNHNTBNNTNTHHTTNNHTHHN
HNHTTHTNBHNTTHNHTTNNNNNNTHNTNNNNNNNTHHNHNNNBNNNNHNTBTNNNHBTHHHTNTHNNTHTBNNTNHNHNNHTNBNNNNNNNTNTNHBNT
NNTNNNTNTTTNHBNNTHNNNHNNNNNHTHTNNTNNTTTTBNNNNNNNNTNHHHHTNHNHNHNNTHNNNNNNHNTNNNHHNTTTTBHBNNBNHHNBTNNN
NTTNTNNNNNHNTNNNNHBNNBNHTNTHTHHTTBNNNNHNHBHNNBNTHNNHBNHNHNTNNNHBHBTNNHBBNNBHHTNHNTNNTNNNNTHNNNHTNNNN
HTHHTTNTHTHNNNNNNTNHTTNNTBTHNBBTHTNTBNBNHBTNHNHNHNBNBNNHNTNNNHTNNNNNHNTBBNNBNHNTNHTNTNNNHHNNNTNTTHNT
NTHBNNTNNNTTNBNBHNHBTHNNBTBNHTNHNTHNNNNNNNBHHNHNBTTNTBTNNNNNTHNTTTNBTNTNBTNNNNTNNNBBNNHBNNNNNHHNBHNN
