2111211313112312110321110111110102112103211012110121212333311211120313322123211230023113212113112213
3201023211110212331102312331132212112131111211331111320211123011230132111100112111013112113131201121
2101231111132213111311121323121310211223121122021333121111101212111210311311122212012320300111031113
1203131121223311223113121311131121333011122011311210111121111101111130112112111311321131112320213201
2303321221311301112331211212110133133112312022111111231123110233111112111213013330310131111130111312
1322302112013321111013131112213131301102123131111130111220123011211111121120130121110121232213313322
2123110112121111113321312111111121011211110112313111211131222311231111111112313010111202320111210332
1013011311133213301211311110112222121123311323111311311121221211112111113311122113111130312132131123
1313211102321121111033213121112113301121101211111201021233110211112110131012111311131113231112312123
2011111012133131313203103012031012123322211213022111100310313212120332101113111312211111330131231132
1323013010213131211323111120111121311133110212111031220323112211211331211011123311231313113313221131
3223111133132311223202221320213112111132323132213132123211211231230212330231111133211103121213111310
3121111131122302112111311221311213111121211312201110211132321111011121131011201113321331123113112221
1132120211123112312221111111131231112211323113312211113123312111132121322120121120121120321100122110
1131012113031222321212311301121101312333130313122333111201311110202332113113212201121321021111130331
1113113231111132232122112131113112111011112013313131131102311131321311111220111132133110111310100101
1131131201132131312111223101321202131131021222113321130311311121121233021012112213101132011231311212
3133133222102311122331312311321122131321331111111332233211131011131230022112121331013103111131130111
2122131130122311133113312322021101311123030123011331131311111123223231111113332211012322030131111101
1213112001130300121130311112101131131312121112211212313120211231303331111121121011131122111233303101
2222131223322312231121113112121123113130111232011111011103113022113231121031111122113221111131201321
1331111111211121231110111032322221201311111111303112011112111103102113333203111212121111113311333311
2101311231110121212321213333311113111101103312031121023111111121131323122211101221333133311112311231
3321111211121011131122112010113303313311211111131323331103111311311013113211120113022313111313211012
0131132121102111131221130113113121021331211330330331223321133211222232131220122122311111211111232110
2211120033111131121111102101120111323123012212111331113201332231101112010131111323021131221112223113
3110123201101213321033133321113131111133112210121103211233131121101311211211111310111111311312110110
1120233031133132221101111311103111312111221121121122330132111111201120132331011201212231103323111302
1202122231220223332101113311311101101113113121111132000311201102211123312102112210131113211221212311
1211213112001121211102111313031323221112123001211111211112210201201231120311223311311133311121121111
3122111131323322202121211120112023130131312201130210223113121110213111300111030111101211112111213311
2222122210021120213103121332211111333121101213211112313321311111012111112211131111101022330112311111
0102013330002121130313112320111331211333111122131220113313111132212111133231211123011331123110110233
3111323003102023021121313123013123130131331113313011011001111332112001111021302111011111013112011012
1330210102131111130213212121110112131321113320023111311311201112120323211230320223303313121123311113
1331232212110311121332131111111313331321312011311301001320213311113103132310301311013221111011121102
3113112301011113213212031212133320131120303311312210201313221013331211221331111210211112322131131202
3212213332112113133131101212321101111121321311111111112131111111222111111100322121322313112111212111
3113111211111112131301013131021322221111321131010111011301303111112132111131100111211000110201313111
1013311131022311310032111113223022311102231213131102033030132111012111011223311113301311312301321313
2103130212232110223011132103213001212111312111113221221112113230111111122231103132213321110313112111
1013111111311131111131103223121323211313011122111303311123222201212311222213311121113122111311132100
2301331311131221221333211333031111130201121231311221321313101131131031210011122122231101123131121133
2123012310201320223012313111331011111121301111120230123112211331311321110122121111111111111103131021
1133101002131303132211311110312112131031011113233122320011310211131103101311011301131023213132311111
2110321112112311111111121111222002020213312021122211212112032111132112211120121231011121012133111123
1111201100132330101011121131103131031131211301111111211301023300333102110132101222211011011021111131
1121002130221233132130202012131131212021330313311112111302221221031102333113221331331323321121031102
1111133111213330111111311101122031111121213113231310211002031111100021322321111321302131331112113122
2221312110321232113113231223130110111032230311301223113013330232110112331132113331111021310111133212
2101131311131312133030223102131131311221133133112122321131111113112121111111121112033111311312021211
1121010312213111313202001211113311113123211012311210311120111111301211111301031211101321033112201102
2113113321133111122211111110011120313001121313103111222111131111121102111323132121101122113321113311
0131313321113113111130031111121303113131231111212132021201021321311211201133113211131113113012213232
1121132332101321121112111301021112111211122111133133121201332311111311321131211131110111021121121312
1312121131311111121211131111331310111200131231121112201100111121210221330320112012131111110013111111
2311313113221120113031332110211131101121123013211231131233133123001320311120201111232013231331113311
1131111112111112111120012321021311131032111211211111113230131123211110301102301131102101110231001000
2311212132333110123333211131131211011111130111111112111203331232211133233113111111211102101313110011
1210101012131131331203110111212023101132110212112121111123113210203232321331023311011212231121311311
1111111111213322222130222131133311323230213110122112111310131000202133111133113311101212011113310231
1111311113013321013111011232110131203321111131122110103321310130112122110211311331310222211311231221
0311331211111222111112112212021101112320121122322320311311011111313121112112311311100011013111311111
1220100111201321111303011311130211121311120020131121320102111323110113111203223231013321211123113331
1002333211311103111122323123112113202111011311031323311222131011113111012021113121313131013211021221
1112320020111321133133033321111001111011012111113301011121112313231230221131110110121321211113331011
1101323301312211021233311312122213121112232101031211121212310013122111310311011111111311311011123221
2113111111211112111212111200313011123131113223233301223232302321101302111111211212221222301311121311
2113120303111313221113101113100111322202311231131302131112211131011213111311232111121331012301312201
1133131311111123301022213312110012121101210111111011012110123222112033231232101130010031010223101122
1210021132011311113211013112311311213311223322111101111313131011133111300111111223112113110121302113
1111112112303121111021201322312122311321312111101132232121131111111112101021212112321132111131113223
1112010031211121011102111011112110121131112102111202121213111203213130110301321201132201122023312111
3311312122110131311300133312311321121011011112010111311110320333211122013031202121022323203123303112
1122131113113012301313311302303323331112232123011330221131211130311310211130110332111111102110321201
2311122131232211121111131223110031123002131122130121012111312311122113123213110211003133331131111113
1122113333122312311122111112121111212301120111213313211203121211011010121121123012111320112131112211
0111110113121311302131322122111113133112123132221112103211111211110110222311201020113301112113111111
1131213123101121211312213113111133211011112012013111111123211012131312311223212312102331311221232112
2130012113133112102001200101111132230232221202113113233101212130101310130213202212111131121333311331
2222131021301011123211102323100231111011033132112110111213111230223213333133121101122111101121212111
1232231302120131111322221311120301221311011311123233211212112111223201112211222233131313212121330111
3221332131302031111213211112223211202211211110021113321113031131112211110221311112132213121132231013
1321122123101132312322211111133131112231012111211011113213120213003121211132131312221212121211111212
1311220102131211313111332202201131231111231131111101111111101132112133122131301012233231111111211013
0213102212223213113111102111101232112113112201112332112321112231123133131113221221122101111113331131
1101102011311313132322111112311222110311110133111321111111121121122232002311111112221111111131232111
3123111111110112101100311203331313121010313311122133001211121123113301102232130211113302231311321011
1211111233111131313131111320231301111211101110112111212223132311233220320111113230001113322311111221
3201121130222221212020033132121301131032331332013203131312001001201221113003113311123111101311112113
1123111133312113113211112012110101013121012233111131131311111311131212321332133311231231111013213223
1311221131313311231113131031011113112132000311211130111230130011111121232101222232122211321321311321
2012112031211132322121131333111112112112210323311213330211113333121112110311013222011023321011011130
0112110211113121221111101112330131111232123332113210101012311301123121121121231111031220111310012323
1102331211321111221221310121212210223331013111132113201101131120111033023111221112132121111112101310
1313233210212322311211121003222111201121111323112333133311112111320111013123331112122331113111310131
2211133133132132123210311011102131112332101321203110113111121213011111331112111101233133133112131113
1011211111211023111321113113111303221313033010210011221001311113331121213112121012233133111101033022
3112233123311312312332321131233211033131100111311323130133332121113123121111211223113111211121111113
1113331121111111313113211332323111110113011132103111302213231012111301131111313103211111111111321011
