HNHNHTNHHTNNNNNNNNHNTNHTBTTTNTHBBNNNBTBBNHNNHBNNNBNBBNNNHNHTHNTTHHTNTTBNTBNNNNNHBBNHHNHNNNBNNNNTNTBN
TNNTTHNNHNBNHTTNHTHHNNHTNTNNNHNNTTNNNNBNNNNBBTNNNHNNNTHNNNNTNNBTNNTTNNBTNTHNBHBHNTTHTNNTHNTNHTTNNNHN
TBTNHHTBNNHNNNNNTBNNNHNHTHNNNTNNNBBBHNNHHNNTNTTNNNNTNHNHHBTNBHNNHHNHNTTHNBTNTBTTNNHNTTNTNTNHHNNNHNNT
BNNNNNNHNHBNTNBHNTNNTNNNNNBBBBNBTTHTNNBNNNHBNTBNNNTBNTNNTTNHBHHTTBTHNBNTNNNTTTNNNBNNNNBNNBTHNTNNNNTN
NNNNNHHNNTHNHNHTHTHTHTHTHNTHNNTTTTNTHNNHTNHNTTNNNHNNNHBHNNTBTNNTTNBNTNNNNNNNTTNNNBNNNTHNBNNBHNNHNHTN
HHNHNTTNNHNNBHTNNNNNNTNNNNBNHHHHHNNHTNNNNNNTTNBNTNNHTHNNBTNBNTNNNNTHHNNHTNTTNTNBHNHTTTTHTHNTNNNTTHBN
NTNBNNTBBNNNNNTTTHTHBHHNBNNNHTHTBTNTNHTHNHTTHHNBNNNNBTNHTNTHNHNNNNNHHBHHHNNNNBNNHNNNNHHTHTNNNNHNNBNN
NNHHNTNHTNNTNNNNTBHNTBHNNNBNHHHBNTNHBHHNNNHHNHTBNBTTNTNTTHBBTNHNNTNTNBTNTNNHNNNTNNTNTNNBNNTNNNNTTNBT
HNHNBNTHNTNBHNNNNNNHHTNNTNNHNTNTBTNNHHBHTNTTNNBTHNTNHTHTNNTTTNHBTNNHHHNNTNHNNNTHBNNNTNNHNTNTTNNTNHNN
NNHHHHNTHNNTNNNNNNHBTBHTNNTNHHNTHHNNHBNHNHBNNNNNTTNBBNBTNTNTBHNHNBNNNHBTNHNHTNBNTTNNTBTNBNHNNNNTNTHT
NBTHTNTNNHHTNHTNNBBNNHTBTTNBHNNNTTTTTNNHTBTTNTHNHTBHNHHNTBHHNNHNNNNTNHNNHNTNNHNTNTHTNNTNNNBBTNNHTNNN
BHNNNBBTTHHNNNTNBHHTTTNHTHHHTNHHTTNBNNNNNNNNNNTNNNNNBHHNTNNTNHNNHNHNTNNNHBNBHNNNHTNHTNNNNNHNTBTNNHBN
NTTTHNTNNNTBHTNNTNBTHNNBNNNNNNNTNTBNNNNNNNNNNNBNTNNBTHNTHNHHTHNTTNNNNNTNTNTNHNNTHNNNTTNNHHTNTNNNNHNH
NNNTHNNTNNNHNHTTTNNNNTHNHBNTTBHNTHBNNHNTNTNNNNNTNHTBNNTNNNNTNTHNBNTBNNNNNNNTNTTBTNNNHHBTNNTNBNNHHNTH
BNTNNHNHNTTNNNNNNTHNNHHBTBNTNHTHBNBNHBTNHHTTNNBTHTNNTBTHNHTNNNNTTHTHTNBBHTBHNHNNTTHNNNHTNTNNNNNHNNNH
NBBNNTNHNNNNBNBNHTNBHNNNNNBNBTNNNHNBHNNTHBNNHHHNNNNTTHHNNNNNTNTNTTNHTNTNNTNBHBTTNNHTHNTNBTTTHNNNTTNN
NNHHBNBHTNNNTTTNTNHNTTNNHHTHTTNBBNNHNNNTNBHNHBHTNHHNNNBNHNHNNTHHNNTBNNNNHNNBNNHNHNTNNBTHHNBHNTNNTTNN
NBHNBBNNNHNTNNNNNNTNTNNHBTNTTNHBNNNNNHHNBTHNHNHHNNBBHBHNTNNHBNNNTNNNNBHTTBNNNHNBNHTNTNHHNNHNHTBHTNHH
BBNHNHHNTTBNTBNNNNHHHHNNNBTTBBTNHBBTNTHNBNNHNTNBNHNNNNNNTNNBNNHNTNHNHHNNNNNNNHNNNBNBBTTNNNHNHTBNTNHN
NNNTNHBHBHNNNNNNNNHNHHNTHTNHNTNTNTNNTNTBNHNNNNNTHHNTNNBNNBNNNTNHTNNHHNNHHBNNHNNBNNNHNTNNNHHHTNHHHNNN
NTNNBHHBNNTTTBHNHTHNNTNNTNNNNTNNNNNHHNHHHNTHHTNNBNNBNNNTNBBBTNNHHHNNBNHNHNBHNHNNHNHHBNTNTNBNNHNTNTNT
NNHHNHBNBNTHBBNNTNHNNTNTHTBNNHNNTHHNHNNNHNNHBNNHNNNNTNNNHNHNNNNNNHHNTNHTHNBHNNNTNNTTNHNTTNHNBNNTNTNB
HHNNNNBNNTTNTTNNHNNNTTHNNHHNTNNTNNNNHNNNNBHNNBNTNTNNNNTHHNNTNTBNBHTNHNHHNBTTNNHHHTNHNNHNBBNTHNHNHNHH
NHNBTTBNTNTTNNHBTBNTBTNNNNHNNHNTNHNNNNNNHHTNTHNBHNHNNBNNHNBTHTNBHTTTBHNBBTHHNNTNNHHHNNTBBNTNNBNBNNNN
HNTBNTNHNNTNTNHNTTNBNHNHTBBTBBHNBBTBNTNTNNNNBNNHNHNTNBHNHNHNTBNNNNTNBNHTBTNBNNBHNNTBTNHHNTHHHBNNNTHN
HTNHBHHTNBTNTTTNTNHTNNNTBNNBTNHNNHNBNTNNBHNHTNBHNTHTNTBNHTHHBNNNHNNNNNNTNTNHNNBNNNNNHNBTNNHHTHTHNNNT
HNNHNTBNNBTNNTBNNNNNHHTTBNNTNNNHNNNNTNNNHNNNNHBHNTHNNNTNNNNNNBTNNNNNNNNTTNNTNHHNNHNNTNNNBBNNNBBNNNNB
NBNNNHNNBNNBHNTHTHHBNTTHHHNTNNHHHNTNTNNNNTNTNHNNNHNNNNTNNBTHBTNNNNNNNNNNHNBBNTNHNHHNBHNNNNBNNTHHTNNB
NNTNBTHTHTTTTNNNHNNNNTHHNNHHHNNNNNNTNNHNNNTNNNTNTNHNNNTBHHBNNNNTHNTNBTBTHTTNHNBNNNTTBTHNNHNNHTNNNTNN
NHTBNTNBBNTNBHBTHTNHNNNNNNNNNNHNNNNBNNBNNTNNBNNNBNBNTNNNNNNTNHNBHNNNHHBTTNHHNBHHHHHTBNNNHTNHTHHNBHTH
NNTNNNBTNNBHNNNNTNNTNHTNNTTNTHNNNHBBTBNNNNHTNBNNHNNTHNNNNHTNNBNNNHBNTHTTHNNTTTNNNNHNTHNNTTNNNTNHNNHN
HNNHHNNNHHNTHNNNNHHNNNTNHNHBHTNHBNNNHHNNTHHBNNTTNHNNNNHHHBNNNHHNNTNNBNNBNTHNNNNNNTHTHBHNNHNNTNTTNTHN
NNNTNHNNHTHNNBTNNBNBBNTNNNNNNNBNNHTNHHNNNHTNNHBTTNNTTNNTNNNNNTNNHNNNHBNNNNNBNHNNNNNBNNNHNNNBNTNNTHNN
NHTHTBBNNTHNNHHTHHTNTHTHTNNNTHHNNTNBNNTTNNNHHNNTHNNNNNBNNHBNBNHNHNNTTNNTNBNNHHBBNTNNNNNHTTNNNNNNNTNN
NHNNHBTHNNTNNTNTHNNNHTHNNTHBNNNNNTTHTNNNHNNHNNBHNNTBNNNNHHTNBHNBBHTBNTHHHNNHNHTTNTNHNHTNNTHHBTTTTNHH
NNNNHNTTHNNNTHNNBHTNTNNBNTTTHNTNNHNTHNHNTNNNNHNNBHNHHNTNNTNNHNTTNHNNHHNNNTNNHHTNNNTNNNTTHNTBNNNNHTBN
NTTTNTHHHNHNHNNHNNTHTHBNNTNTNTNNNBNNNTHTBNNHTNNNTNBBNTHHNNNHHHNNTTTBNNNNNHTHNHNTNNNTHBNNNNNNHTHHHNHH
NBNTHNTNNTNTNNTHNHNNNBHHNHTBNNNNNNTHTNNNNTNNHNNHNHTHBNNNHNNNTNTBNNTBNHNBNNTNNHTBHTHHNHTNNNNNHNHNNNHN
TBNHNTNNNNTTNTHNBNNNNBTTHNBBNNNNNHTNHNNNNNNTNTNNHBHHNTHNHNNNTHNNBNHNTNTNTTHBHNNNNNNNHBNTNNNTNBNTHHNT
NNHHBNNBNTNNTNNNNBNNNNNTBNTNBTNNNHNHNNNNBTTTNTHNNHHTNNHNTTHTBNTNHNNTNHNHNBNTBBNNNNTNTNHNHBBHNBTNNHNT
TTNNHNHNNTTNTTNHNNHHNNNNNNNTNTBBNHHNNNNBTHNHNTTNNHTNBNHTNNHNNTNNBNNNHHHTHNHNHNNNNTBBHNNHNHNHBHTNBNBH
NNNNHNHNNHTHNNTNTBNNNNTNHNBTHHTNTHNTHNHHTNTNHNNTHHBBBTNNNNNHHNHNHHNHNNTNTNTNNNBBBHTNNTNNTNTNNNBNNTHH
TTNNBHNBTNTNHNTNBNTNHBTNNNHHBTNNHNNNHTNNTNHHHNTBBNNNNTTNHTNNNBBHNBNNNNNNTTNTNHNNTTHTNNNNNNNNTNTNTHNN
NNTNNHTNTNNNNNBHNNNTNNBBNTNHNNTNNTNTNNNHBNNNHTNBNHNNNHTBNHNBNTNNNTBNHNTNNNNNNHNBTNBNBNBNTTNNHHTNNTBN
BNNNNNHNHNNNBNTHHNTNTNNNHNNNHHBNNHNTHNNNNBNHNHBNHBBNNHNBHNTNHTBHNBHTNBHNHNNNNNNNNNNTNBNBBNNTBNTNBBNB
NNNNBHBNTNNTNNBHHNTTNBNTHHTBNNHNNTNHTTHHNNTNNHNTTNNNNTNHTTBNTNNTNHNBHHHHNTNTNHNNHTNNHNNNNNNBNHTHNTNT
TTNNNNNNNNTNBHHNNNHNBNNNNNNNBNTNHNHBNTHHTHHNTTTNNTBNNNNBHHNNBBHTHTNTHHNTTNNBNHTHNNNHTNHBNNHNNHNTTHNB
NNTHHNNNTBNTNNTTTHTNHNNTNBNNNNHNNNTNTNTNNTNNHNNNNTHNNHTNNNTNNTTNNNHNNTHTNNTNTHNHHNHNBTNNNNHNNNHTNTNN
NHNNNNNNTHNTNNNNNHBNHNNNNNHHHTHHHTBTNNHTNTBHNNNTBHHBTNHHNNNNTTTNNHNNTNNNHHHNBNNNNNNBBBNTHBNNTBBTNNBN
HBNTTTNNTNHTHTNNNBNHNBNHHTNBNNNHHTBHNNNNTNNBBNBHBNNHNBTBBHHTTBHHTNNNNNTNBNHHHNNNTTNNNNNNHTNTNHNTBNHT
NNHBNTNHNNHNNTHNHNHNNTNBHHNHNNNNHNTTNNNNTTNHTTHNNHNHTTHNHTHHHNBTBNTTNNNNTHNHNNNTTTHNBNNTNHHTNNTTNNBH
BTNHNNHNNNHNNNNTNTHNTNNNHNNNTHTHNHNNNNTHTBBHNNNTNBTNNTTNNTNTNNNBNBTBNNNBNHTNBNNTNNHNBTNNTNTNTTNHTBNN
NNTHTNHNNBHTNBHTBHHHNTNNNNBTHTNBTBHNHNNTTNTHHNNTNTNHNHNTHHTHNNTNNNTBNNTNBTHNNNBNNTNHBTTNNHNHBNNHHTTT
HNNTTNBNHNNNHNTBTNTNBNNTTTNHNNTHHHNNNNTTNNNTHNHTNNTNNNTNNNNNTHTBHNTNNHNNBNTNHHHNNHTNHBHHTNTHHTHHNNHN
HTNNBTTNTNHBHNNHNNNTHNNTNTHNNNHNNNHHHHTBHBNHNHNHNNNNHNNHTNHTNNNBNNTHNNNTTNTNNHNNNHNBNBNNTTHHNHHNTNBT
BNNNNNNNHNHBBHBTNHTTNTTHHNNNTNNHNNNBHTTNNNNTNTHNBHNHNNNTBNNHTHNBTNHBNNNHHNNHTTNTNTHTNHNBNBNHNTNHHNBH
HNNNNNHHNNNBNHNHNBHNHNNNNBNTHNTHTNHBHNNNNNNTNNNNHNTNHBHTNNNNNTTNNTTHNNBTHHHNNTBNNTNTNHHTHTNNTTHHNNNH
NNNNTBHTNNHNTNNNNNHNHNTNHNNHHNNHBNTTNHNNHTTNTBBNNNNHNNNNNHBNHNNNTBNHNNTHHTNNNNHTNHTNTTHNNTHNNNNNHTHH
NTNTHTBNTNNHHNNHHNNHNNNHBNBNNHTHHTTNNNHNHTNNNNTNTTTHTBBTHNNBNBNTNNBNTNNNNHNNTBHNTNTHNNNBNNHNTHHNNNNN
TTTNNTNNNNTNTTNTNHHTTBHNNNBNNBNHTNBTNBNTBHTNHNBBHHNBTBNNBHHNTNNNNNHNTTNHHNNHTHBNHTNNHNHNNNNBHNTBHNNN
HNTTHNNBHNHNTNHNNNNBHHNNTHHNNBNTNNNTTNBNNNHBNBNHTNNNNHNTBNTHNNHTNNNHNNTNNBTBNNTNTNBNHBNHNTNHTNTNHNTT
HHHHNNHNNNTTNNHNNNNNNNNNNNHHHNNNNBNNNTNTHTNNNNBHHNBNNNTNBHTNNHNNBHNHNTNNNNNBNHHNNNBTTNNTHTTHHNBNNNNB
BHHNHNTNNHNBNHTTTNNBHTHNNTNNTNNTNHHTTBNHNNTHHHNTHNBHNHNNTNTNNNNBHTHNHTBNNHHHNTTNTHNBNNNNTTTNNBHNNHTN
NNHHNTBTTNNNNNNNTTHTNBNTNNNHHNTHHNNHBNBHHNHTHNNNTBHNNTNHHTNNTNNNHNHHHBTNHTHNNNNNTNHBNTNHTNTTNHBNNNHN
NTNNHNBNNTNHHTNNNHNNTNHNTNTNTTTHTNNHHNBNTNBNTNHHNTTNHBNNNHNTBTNHHNNHNNTHTHNNNNNNNNHHNTNHHNTNNNNNHNNN
HBTNNNNNTNTNNNHNTHBNTNTHTNHNNHBBNNBHHNHNHTNNNNNHNNBNBBBNTNHTNTNNNNHNNNNNHNBHHHBNTTNNHHHNTBNNHTNHHTTT
NNNHNNNNNNBHNHNHNNNNBNNNTHTHNHNNHNHNNNNNBNNHBTTNHHHNHTHHBHHTNNBHTTTHTTNBNHNNNNBHTTNNTNTNTHNNBHNTNNNT
NTTNTNHNHTNNTTNHNNBNHTTNTNTNNBNHBTTHNBNNNNNNHNNTBHTNTBNTNNBTBTNHTNNNNTNHNHNHNHNHNNNNNNHNNNNHHBNNNNTN
TNHTNTHHTNNHNHNTHTTNNNNNHBHNHNNTTTBNNNNTBHNHBHNHHNNNNNTNTNNBTNNBNHHTNNNTNNNNNBTNNNTNTBNNTNTNTBNTHHNH
BHTNHTNNNTNNHHHNNNBNBTHNTBNNHNHBTNTBTNTTHHNNNNNTTBNNHBHHNNNNTNTHNTNBHNHHBTHNNNNNBBTNNNNNNNNNNNNBNNTN
TNBNBTBNNNTHNHNNTNNNNTNTHHNNTTNTHBNNNBNNHTNHNNHNNNNNHNNNNHNNNHHNNBTBTNTBNBNNNNNNTHNNTNBNHNNBTHTTTNHN
THNTNNHNHNNBHBNNTHTHNNNTNHNHHBBNNNNNNNNNNTHHTTNTHNNHNHNHHNNNNHNHNHNNTNNNHNNHNNNTBHNHHTNBNNNHTNNHTHHN
TNHNTNNBTNNBNBBNNNNHNBHNNNHNHHHNHTNNBBHTNNHTTTNBNHTBHNNNBBHHNNHNNNNNHNHNNHNTNHNNNNNHNHNNHHBNNNNHNHNH
NNHHNNNHHNNNHNNHBNNNTNBNHTNNNNHNNTNTHNHHNHNNTNTNHBHHNNNNNTTNNNNNNNNNTHNNBBNNTTHNNBNNNTNTTHBHNHTNNHTN
NNBNTHNNHTNNTTTNNNNNTTNHHTNNNHTNNNNHNNNNHHTNTNNNNHNNNNHTNNNNNNNBTHTNNHBNNHHNNNNNNTBHBNHTNTNNNBTHNNNH
NTTNNTNNNHNNTNTTNTNTNNNTNNHNNHNNNNNTTNNNHNNNNHNNNNHNNBHNNNNNTTBHBNNNNTHHTNNNHTNHNHNNNNNTNTNNNTNNNNNN
NNNHNNBHBBBHHBNTNBTTNNNTNNBNNNNNTNTNNNNHHNTTBBNHHTNHNNTNHTHNNTTNNTHNHNNNNHNTHNNTNNNNTBNTTNTHHNNTHNHB
NNHNNHBNNHNBHTNNHNTNHNHBNBBNNTNNTNNTNNTNHNNNNNNNBNNTBHTBHTBNNNHNNNHHTNHNNTNNBHBHHHNNTBTNNNHNTHHNNNTN
HNNTTTNTNNBNTTTTTTTNHNNNBTHNHHNHNNNNNHNTTNTTNNBNHTNBTTTBHTHNNNNNNBNNNHBTHTBNNHNHNNTNTNHNTHTTHNNNNNHN
BNHBNNNNTHBTTTNTNTNHNHNNNNTTNNTNTNHNNBNBTNNTTHNTHHHHTNTNNHTTHNNBNTBTBTTTNHNHNTNNNBNNBHNNHTHHNHBNHNTB
TNHNTBNHTNNTHNTNTHNHNBNBNBNTTBTTNNHNTNHTNTTNHTTHTNNNNNHTHNHBHNTTNTHTNNHNTNHTTTHNBNTTNHNTTHNNNNNHHBNB
TNNNNHBBNTNHNHTNHNNHHHBHTNHBNNNBNNBTNBNNBHHNNTBHNTNHNNNHNNBBBNNHNNNNNNHTTBHNHTNNTNNNNNNNTHNNNHNTTHNH
HBTNNNTTHTHNNNHHHNTNTNHTTNNBTHHHTNNNTNHTHNTNHTHTHHHHBNTBBTHTBNHNBNBTNNTTNTHHNNNNNNTHNBNNNHTNNTNTHTNH
TNNBNNNNNTNNTTNHNBBNTNHNNTTNNTHNNTBNBNNNTNHHHNNHTHNTNNTNNNHNHHHHNTTHHNNTNNNNNTNHNNHTHNNTHHTHNNTTHBNT
BNHHNHHNHHHNTNNNNHBNNHNNNTNNNNNNNHTTTHNHNNHNBNBTTTNNNTTTNBNHTTNNNNTNTTTHHNNTNNBNHNNNHNBHTNTNTNNNNHHT
NNNHNNNNHHHNNNNNNNTNNNHTTHTNTHNBNNNNHNNTNNHBTHNHTNNNTNNTTNNTTTBNHNNNNBHNNHHHHNHHNNNNNNNHTBBBHNNNNNTN
NNHNHTBNNNTBBNNTTNTTTTHNNTNBNTBHTTHNTBTNHHNNHNHNNNTNHNNHNNNBBTNHHTNHNHTTTNTHBTTBNNNHNNHBNTNTHNTNNBNH
NNHHHNNNBTTTHNHBNTBNTHNTHNNNNNNNBNHHNTTTTTNHHBNBTNNTNNNNNTNNBTNBHNHTBBHHBNNBNNHHBNTNNNBTNNNNNBTTHHNN
TTNNBHBNNTHBHTHHNNNHHBNNNHNBNNTNNNNHNTBTBNTNTNHNHHTHBNNTHNNNBNNNNHNNNNBNNBTTNBNNTNNHHHHNTNHNNNNNTHNB
HNNNNNBNNTTHHHBNHBNNNTNNHHNHNNHHNNNBHHHNTNBNTNBHNHTNNNHNNNNNTNNNNTNTTBBNBHTTNNNNNHNHTHHNNNNHHHNHHHNT
NHNNBNBNNBNNTNNNBNNTTNNTBHTTTNNTNTNHNTTNNTNNBHNHNBHHNNHNTTNTNNBTNNNNNTNNHNHNHNTTNHHBBNHNNTHTBTHNNTTH
NHNBNHNBNBBNNBNNTHNHNTNTNHHTTHHNNHNHHNHNNTNNTNNNHNTBNHNHHTNNHHTBNHTNNNBNHHNNBHNHNNNNHNNHHTTNTTHBHHNN
NNTNNNHNHNHTNNBHHHHHNTHTNTNBTHNNNBNNTNHNHNNHHNNNNBTHBNTNHNNNHTNHNBNBBTBBHBTNBNBTHTNNNHTTHHHNNBNNNBNN
NTTNNBTTNNNTBNBTNNHNHNNHBTNTHNBNTHHHTNHBTNNTTTHHBBNNHNNNNNNTTNNNNHTHNNNNTHNHBNNNTNBNNBHNNBNNNTNHTBTN
BTTHNHNHTNNHTHNTTNHTTTNNNTHNBNTNNNNBHHHNNNNHNNNNNNHTHNNHNNNHNHNNNTNTNTNNNNNHNNBNHTNNHBTHNNTHHNNNNNHN
HNTTNHNNHHNNTNNNNTNNNTNNNTNNNHTHNNNTBTNNHNTTNTHHHHHNHHHHHNBHNHHBNHNBNNTNNBNNHHBNHNHHNNNTBNNBNNTNTHTT
NNHHHHNHNNTTHTNNHBNTTNNTTNTHNNNHNNNNTNBNNBNNNTNNTTTTHNNNNNTTNNNNNHBNBHHNNHNTTNTBNBTTTNTNNBTNNBNNHNNN
NNNTNTTHTTTTNNHBNHTNHHBTHNHNNTTNTTTNNNTNBBNNHHNNTNNTHNNNNNTHNNBNNNNNNNHHBHNTNBNNBHNHTNNNBTNNBBNNNTTB
NNHHHNTNNTTBBNNNNNTTNNHNNTBTNNNNTHTTHNTNNNHHHNNNNNTBNBTNTNBNTNNHNNNHHNTTNNNTNNTNHNNNTNTNNNNNNBNNNTNT
HBNNNNNNHNHTNTNNNBHTNBBHTNNTNNNNNTBNTBTTNNNBNBHNNNTNHHBBNNNHNHTNNNNNHHNHHBNNHHTTNNNNTNNNNHHNNNNBNNTH
