TTNBNTHNHNNTNTNNNTHHTNNHNNHNNHNHNHNTNNNHHNHHNNTTTNNNTNBBNNTTNNNNHNTNNNNNNNHNBNNNNTTTHBNBNNNNBNBHNHHN
NBTNBNNHHTHBNTNBTNTHBNNNBTNHHTHNNTHNNNNHHNNNTNHBNHBHTHNNTHTNNHNNTBBNNNHNHNNTNTHHTNNHNNHNNHNBNBHNNNHH
NNBNNNHHNNNTBNHBHHHHTHNTBBNHTNTHTNBNNTNBTNHNNHNTTNNNNBNTHTNNHHNHNBTTHNBBNNNTBBNNBNNNNHNNTTNNNTTNNTTN
NTNNNHHHTHNNTNNHNNNBTHTBHTTNNHNNNTHTNNNTBTNNTNTBTHHNTNNNNHHNNHNNHNNTNNTNNNNNNHNNNTNBNBNNNHTTNTNNNNTH
HTNBBHNNHNTBNHNNNNNTHTHNTHNNBNNNTHHNNHNNTHNNNHHNNNTBNHHNHNBBNNTBTTNHNNNNNHBTHHNNHBTHNNNBNHNNNNNHTHHB
BHHNNBNTNHNNNHTNNNHBNNNNNHNNTNNTNNHNNHNNHNNBNTNHNNNNNTTTNNBTNHNTTNBNNNHBNNNNNHNNNHNNNNNBBHTTNHTNHNTN
TTHTNNNHTTNBNNHNNTTNNHNNHNNNTHTHNBTHHNNNNNNNBTHTNNHNHNNHTNNNTBNTHTTNHNNNHHNTNNHNTNNHNNHNHHTNNNTNTTNN
TTTNNTNNHNBNNNTHHHNNTHTHBBNNHNNNHBNTTHNTHNNNTNNHNNNHHNNNHNNTNBBHNNNTNNNNTNTNNNNHHBTNTNTHHNHNNTNHNHHN
NBNNTTTBNTTTHTNHTTNTTTHNBNNTTTNBNNNHTNNNTBTNNTNNBNBTTTTNTNHBTHTNTNNHTHNNNHNTHNBHTHHTTNTNNHNNBNBHBNTT
NTHTBNNHNTTHTNNNTTHNTNNNNHHHNHTTNNBNNHNNNNNNNNHHBTBTTBNHHNNTNNNNNNNHBNHNTNHHNTNHTTNNNNTHHHBTNBHNHNNT
NHNHNHNTTNTHNNTNNTHHNNTHHTNTNNNNHNHHTNNNNHNHBNNNNHTTHHTHTBTNTHNNHNNTNHBHNNTHNNHNNHNNNBNHTNHHNNNNBNHB
NNHNTTBHNHNNHNNNHHNNNNNNNNNHHBBNNHNHBHHTNHNHNTTBNNTNHHNTNNNHHHHNNTNTTHHNTTTNNNNTBNBNTNNNNHTBNNNHHBTB
HHNNBNTBNNHNHHTTNHTNTHNNNTNNBNNNNNNNHTTTNHBNTTNNNNTHNBBHNNTHNHBNNHTBNBHNNNTNTTNNNTBNNTNHNBNHHNNHBBNT
NNTNNHHNNNNHNHNTNNNNTNTNHNHTTNHNNBNNNNTHNHNHTNNHTTNNBNNNBNTHHHNNHTNHNNNNHNHBNHNNTNHNNBTTNNTNNNHNTNNN
HNBNTHNBTHNNTNTTNNNTTBNTNNHNNHNTNHHNBNNHNNTNTBNNBNNNNNTNNNNNNHNHTNNNNNNNNBHHNNBHNNNNNBHTTTHNNTHBTNNH
THNHHNNTNNBNTNHNNNNHNNHNHHNNNNNTTNNNTNTHNNTHTNNNHTTTNNTBHTTNNHTHNTHHNNHTTNTNTNBNHNTNBNTTTTNHBNNHBHNN
TNHTHHNTHNTNHBHNTNNTTHTHNHNTBTHNHNHBNNTNNHBTTNNHNHHHNHTHTHNNTHNTBHTNNNTTNHTNHTHNNHNNNBNTTNBNNNNTBHBN
NNTNNTTTNTTNHBNHTNTNNHBNNNTNNTTBBBNBTBNNTHNNHHNBHTHTTNNNNBNHNNNNHNNHBNHNNHTNHBBNNHHNNNTBBNNNNNHHHTNN
TNBNBHHHTTNTNNNNHNHNTNTNNTNBTNNNHTNNNNHNNNBBNTHNBNTNNBNNTTHNNHBHNHBTHNNHTNHHHTNHTTNNHNTHTNNBNTBHNHNT
BTHHNNNNNTNHBHTNNBNNHTTBTNNNBHNTTNTTNNHTNNNNTHTHTTNNBNTBNHNTTTNHHNTTNTHNTTNHHHNTTTNNNHNHHTNTNNTHBHHN
HBTTNNNNHNTBHTNNHNHTBBTTNHNNNNNNBNHNNTNHNNNHNNBTNNHBBTNHNNNNNNNNTNNNTNHNNBNTHTNBTNNHNNNNNHHNNTTBTNTN
HHNTTBNNHNNNTNNBNNHTHBNNNHNBHNNNTHBNNNNNHBNBTNNHNHNBHTNHHNNTNHBNNNNNNHBHNTNHBHHHHNNNHTNNTNHBHNBHHHTN
NNTTNNHNHHBNNNHNNHHBNNBNNNBTNNNHBNTTTBTNNNNNBTNNTNHTNNHNNNNHTHNNNHNBNHTTNHHHNNBBNNNNHHNNHNTTTNBNTTNN
NNBNNNHBHTNNNNHNNNBHNNNBNNTNNBTTBNNNNHTNNHHHNNNNHNNNNNNNNHNHNNNHNNTNHNNNHNBNHNTNNBTTHNNNHTHNHNNNNNNN
NTNHNTTHTNNHTHNNNHTTTNTNBNNHNNNHBTBHBNNHTTTNTNHNNHHHHNHHNNNBTBNHNNBTNNNNNBHBNNHNNHHNTNHTNHNNNBHNNHNB
NNNHBNTTTNHNHNTTBHTTNTHBNHTTNNBNNNHBBTTHNTNNBNBNNHNHNNTNNNNNNHBNBTNHTHNTNHNTHHNNHBTNNHNNNNNNNHTBHHBN
TNNBTNNNNHNNTBTHHNNNTNNNNHNNNHNHNHBHNTNTNTTHNNTTNNTNTBNHHNNNBHNHBNHNTNTNNNNBNNNNHNNNNNHNHTTTTNNNNNNN
NNNBNNNNNNTNTHHNNNNNHTBHTBNNTTTTNHNNNTNNTNHNNBNHTBNTNTNNHTNTTNTNTHTNNNTTTNNNBNTTNHTNHNNBHHNTHTNNNNNN
BHNHHNBHTHHNTHNNNNNNNTTNNNNNNNNTTNNHTTNHNNNNTHNHNHBNTHTNHBNNNNNTNNNHTBBNNNBNNHNNHNNTNNBTBTTNTTNNBNNN
TTNHNBHNNTHNHBBTNHHHNTNTBNTHNTNTTNBNNNTTNNHHNNHNNNNNNNNHNBNTHHHNTTNHHHTNHNNHHHTNHNNNNNNTNBHNNTNHNBNN
HNHTHNTTBNNHHNNBNTBBNBHHNNTNNNTNNBNHNTNHHBHHBNTHTNNNNNTHHNNNTNNTNNNNTTTNHNHNHHNNNNHHTNTNHTNNNTNNNTTN
NHNTHTTNNNBNHTNNTHHBNNNNNNNTNNNNNTNTNNHNNNNNHNBTNBTNNHBNTNHBHNTNNHTNHNNTNBHHNHBHHBNTHNBNNHHHTTTNHHNH
HBTNHNHNNTNNNNBBNHNTHNTNNNHNTNHHNNNBNTNHBNNBTHNNNNNTTTNTNNTTNNHNNNHNNHNBNTNBTTBNNTTNNTHNBTTHNHNTTTTH
NTHHNNBTBBNBNNTTNNTNNNNNNTNTTTTTHNTBTNHNNNHBBHTHNNTTNNNTTHNNBNNHTNBBHHNBHNNHBBNNNNTHNHNHTNTNHNTTNNHN
TNNNBNNNHNHNNTNHBHTHNTTNNNTHHNNHNNNNNBNNNNNTTNNTHTNNNNHBNNHNTHNNNTNTNNHNNTHHNNHHTNTTBHBTTBNTHNNNNNTN
NHBTBNNNBBBHNHTHNNNNTHHBTNNNHNBHTNNHNNHNTNNHHHNHNHHNNNTNBNNHNNHHTBNTNTBHHHTHNNNTNHTTNNNNHNNNNNNHNBNN
THNBNTBTNNHHNTNNBNNTNHNNNTNNHNTNNTBHNNTHNNTBHNNNNNTHNNTNHNHBNNNBNNNHNTNBHBNNHNNNBHTNNNTNTTNTNNNBNNNN
HNTNNNTHNNTHTTNTNBTHNNNHHNHNTBTHHBNHNNHHNHTTTNTBNHTNNNTBNNNBTNTTBNNNNNBNHHNNNNHNBNNNHTHTBNNTTNNTNHNH
NNTBTNHTHBTNNHHNTNNTBHNHHNBNNBNTNNTHTBNNNHNHNHNTNNTHBTNNHTNHHBHTBHNNTBTTNNNHTBNNBNBNTNHNTBNTBTNNBNNN
NNNNBNHNBTBNHHNBNNBBTHHNBNNNNNHHNNNNNBTHNHTHHBHBNNNTNNTTNTHTNHNHNHHNNNHNHNBNNNHNBNBBTTTNBTHHHHHNNNNN
BBNTHNNBTNNBTHTHNNNHBTNBTTNTBHBNHBTTNHHNNNNHNTNNNHHTNHNHNHTNTTNNNHNNHBNHNNHNNBTHNNHTNHHBNNHHHHNNNNHT
NHNNNBNNTNHNNTNHTNTNNNNNNNTTNNHHTHBNTNNNBHBHTHNTNNHNHHHTTNBTNNNNTNBTBNNBHNNNBNHNBNNNTNHHNHNNBNNTNNTN
NNTHNHHNNTNTBBNNHTBTNNNNTNNNTNNNTBTNHNNNHNTNHNNTBHNNTTHNTNHTBNHNNNNNHNNHTNHTHTHNTBBHHNBHNNNNTTNTNBTN
TTNHHHHHHNHNHNNNHHNTTNNTNHHBNBTTNNBBNTHTTTNNNNNTNHNHNNHBTTTTTNNTTTHBBHBNNHTHTNTBNBNNNTNNHNNNNHNTNNTT
NTBNHTTHTNHHNNHTBHBNHNNNBTTNNTNNNHNNHTNNNTHNHNNBNNTBBNTTHNNBNHNNNTBHHBNTNNNNNTHTTNNTBNBNBNNHNHTHTTNN
HNBNNBNHTTNNNNNHTNHNNHNHNTNTNHHTNNNTTHBNNNNHNTNTBHTTTNHHNTNNNNHHHTNNNNNNNTBNNNNHNNNNNNNTHTTNNNHTNNTN
NTTBTNNNNBHHBTTHHHNTNHNBNNNHTBHHBNNTNNNTBNNNTHBHNTNNNNNNNNNHHNNNNNNNTTNHTHHHHNNHNNBHTBNHNNTNNNNNHNNH
TTHNHNHNNTNNHTNTHNTNHTTHBNNNNNNNNNHHBNNNHHNNTNNNNHNTBNTBNNNTNNHNNTTBNTNHHTNNTNNNNNNHNNNNNNNNNTNNNHBN
NTNNHNTHNHTBNTHNNNHNNHHHTNTTNHHNTBNBTNNNNTNHNHNNNNHHNTTNNTTNNNHNNTTHNNNNNTTHHNHBNHBNNNNNTTTNTNNHBNHN
HNTNHTNNNHNNNNNNNBNHNNTNHTHTHHNNHBTTHNHBNNBNNTHNTNNHNNNBBNNHNHNTHTNTNHNNHTNBNHTTBTNTNNNNNBHBHNHHTTBB
NNTHNNTNTNNHNNTHNNNNNHTTTNTTHNTHNNNNTBHHNHBNNHNBTNNHTNNBNNNHHTTTNNNNTHTBNTNNNBNNNNBHNNNNNHNNNNNNNNNN
NTHNBNNNTNNNNTHBNNHHNNNNNTHNNNNHNNTTNHNNBHNTNBTBHTHNHHTNTNNHNNNNTHBNNBBNNBTNHHBTNNTTNNNBHTNNHNBNHNNN
TTNNNNBTNHTNNNBNNNTNNNNTHTHHNNHHTHTNNHTNNNTHHNBHNHTTHBNHHNHNNTNTNNNNBNNTTNNNNTHTNTTHTHNHNTNNNNTBNBHT
BNHTTNNNNNNNBNHNNTNNTNHNBNTHNTNHHNBHBNTHNNNBNNTTTNTBTTHNNTHNHNTNNHNBNNTNTTNTTNNNNNNNHBNNNNTHNNTTHTNN
BNNBNNNNTHTNHNNBNNNHHNNNNNNNNNHNNNNBNHNNBTTNTBNNNBNBHHNHNNBNHNNNNNNNNNNHNHNTBBNHNNNHNNNTTNNHNHNTNTHN
TBBNTNHTTTTNNBNHNHNTNNHNBNBNTTBNNNHNBNHTNHHNNTNNTTTNNNNNTNNBNNTNNNNNNNTTNNHHHHHNNHNHNTNNNNNTNHBNNHBN
NHHHHHHNBNBBNHNBBHHHNNNNNHHTNTTTHNNNHTNHHBNTHHHTHNHNTTBNTHTHTHNTTTTNTTHHHTNNHHBHNNNNNBNNNHBNNNHNNBNH
NNHTNNNNNNNHNTNNBNTNTNNTNNNHNTNHHBHNNHNHNNNTNNNNNHTBBNNHNNNTBNNTNNHNHNHTNNNBTNTTNHNTNNNNNHBNNNNBNNTN
NNNNNNTNHHNNNTNNTTNNNNNBBTTNHTBBTTHNTNHNHHTTNHNNNNBNNNNBNHTNNHHBBHHNNNBNNNTBNBNNNNBNNHNTTNHNBNNHTHNN
NNNTNNBHNHHNHHNNNTTNNHHHNNBBNTNTTHNNTTNHNNNHNBHHNNHNHTNBHNNNBNHNNTNNHNHNHNTNTNHBTTNHNNTNNNNNHBTHHHNN
TTNHHNNBNTNTBBHNNNHHTBNNTNNHNTTBHNTHNHNNTNNTBHNBTBBBNTHHNBTBNNNNTBBNBNHNNHBHTNTTNHHNHTBNNNHTNNHHNNBN
HNHNNNNTTNNNHNNNTNHNNBHNNNNNTTTBNNNHNNNHBNNNHNNTNTNNNNBNHNNTNTTNNNNNNNBTNNNTBHNHTTHNNNHTHBNTNNNNHNNN
NBNBNBHTBHTHHHNNNBHBNTNHTNBNNNBNNTHNNNTNNTHTNNTHBHNHNNTHNTNNNHHHNNBNNNNHHNHBTHNNHHHHNNNHNNHTNBHNTHNN
THNTNNBTTHTTNTTNNTNBTHHNNBNTTTNTNTBNNTNBNHNHNNNNNTNTBHBNNTHNNNBNNNNNNHNTTTTHHNNTNNTNNNTNHBHHNTNHNHHN
NNTTTHNBHNHNNNTNNHHNNNNNNNHNTNNHNBNHTNNHNHNNNNNTNHHHHHNNTHHHBNNNHNHTBNNTTHHBNNNBNTNTNNNHBTNNTNNNNHTN
NNBNNHTNNTHNBNNNNNNNNNNBNNNNTTBTNNTTTHTNNTNTNNNNNNHHTTNTHNTHNTNNTNTBBHNNNTHNNHNNHTBNBTTNNBNNNTNNTHTH
BNNHBHBNTTNNTTTNNNNNNNHBNHNNNNNTHTNNNNNNNTNNHTBNHTNTNHNNNTHNHNNBHNNTNNNTNNNTNTNNNNTNHHNNNTNHTNNNNTBN
NHHNBBTNNNNNNNNBNNNNHNNNNNNTHTTBTBTHTNNNTTNNTNHHTBNNNHNNNTNNTTTTNHNTNHNHNBNTNHTTNTBNTHTTNNNHNHNTNHNH
NBHHBBHNTNTNHNTNNTHTNHNNHNHNNNNNNHNNNHNNHTTHNBHNNTHTNNNHTHNTNHNNNNHNBNNNBTTNNHNTBHTNHTHBTTHHNHBTTTNN
BNTHNTNNNHNHNTNNNNHTTTTTNNHTTHNHBNHTHTHTNNNTHHNTHBHTTNHNNNNNNNNHNHNHNNHNNBNNNTHNNTNHBNHTNNTNHHBBNTNB
NHNNNTTNTNHNTTNHNNNHBNNNNNTNNNHNTNTNNNNNNNTNTTHNNTNHNNBBNTNNHTNNNHTNNNNNHNNNHNNBTTNHTBNHHNTNNTNNTNHN
NTTNBNNNNTHHHNNNBTNNNTTHTBHNTTNHHNBNNTNHNNNNHTNNNNTNHNNNNTNHNTHNNTBTNNBNNTNNTNTNBNHNNBNNTTNNTTNTNNNH
HNNBTHNHNHHTTNNNBTBNHHNNNNNNTHTTTNTHTNBNBNHHTTHHNNNNTNNTNNNNTTHTNNHNNNNTNNNNNTNTNTTTNHNHBTNHNTNNTHNH
HNNNNTBNNHHNNNHHHTNNNNNHHNNNTNNNNHNTNNNNNHNTHNNNHNNNNNTNNTNTNHBNNNNNNNTNNNHNBHNNBNTBHTTNHNNTNTNNHTNN
HNNNTTNNNNNBHTNTNNNNNNTHNBNTTHHTHNNBNTNBTNNNNNNNNHNHHNNNTNNNNTNNNHTHNTNNNNBNHTHHHBBNNHNBNBNHHHNNNBNN
TTTNHNTHNNTBNNNTNBNHNBNTHBHNNTNBNTNHNNNTNNNNBNNHTNTTBHNNNNNNTNNNNNNNNHNNNHHHNNBHHNNNHTNHNNTNNTBTBNNT
HNHNBNNTTNNTNNTTNHNNNNHTNTTNHNNNNNHNNNNNHTNHNBNNTTNHHHBHHHTNBHNNTTNBBHHNHTBNNTTNNTNNNHNNHNTHHNTTTNNT
BNHTNHHHTNBNNHHNTNTTBTBNNNHNBTHNNHTNNNHNHNNBBBTNNNTNTTNBHNNHHBNHTBNHNNNNNNNNNNNNHBHBNHNNNNTNTNHBNNNN
NTNNNTNTHNTNNNBTBNNNHNBBHNTNNNTNTTTHNNTTTBHNTNNNNNHHNTHHNNHNBHNNTNNHHTHBNTBHBNHNNHTNTBHHHHBTNNTTNNNN
HNNNNTNBBNNNNTNNBNNTHNBNBNNTHBBTNNNTTNNTNNTTNBTHNHNTNTHBNNTNNNHNNHNBTNNBHBNNTHTNHTBNBNNNTHNBBNBNNTTN
NBNNHNNHTNNHHTHNNNNHNHNHTNHTHNNHTNTNTTNHHHTNBNNNBBNNHHTNNTTTTNNNTNNBTNTBNNNNBNNNBNHNNNNBNHNBTTTNBNTT
NNNNTHNNNNBNTNNTNNTNNNNNHNTBHTBTNHNTBBBTTNNNNHHTTNNTNNTNTBHNBBHNNNNNHNNNHNHNHHNBNHHHNTBBNNNHNHTNBNNT
TTNTTHNTTTTBNNNHNNNNHHTNNNHTNHHNTNNNTHNBNHNNTNNTTNHBBHTTTNNNNHNNNTHNHNBNNHNHNNTBHHBNNNBNHNBHNNTHNHHB
NTNBNNNNNHTNNNTTNNBTNTHNTTHHTHNTHBTNTHHNTHNTNNHNNTTNTNNHNNBNNBTNHHNBNNHNNTTNNNTHNNNNBHTNTHTNBBBNNNHN
NNHNNTTNTTNNBHNNNHTNHTTTNNTHTBHNTNBNTTTNBHNBHNNNNHNNHNNTHBNTBNHNBHBHNTNTNHNNHBNNNNTNTNNHTHNNNTNNTNNN
NTTNNBHTNBNNNHNBHHNNNTTHTNNTNTHHNTTHNTTHBNBNNNBNNHTNNHNHBNHTTNNTNNNTNBNHNNNBNNNNNBHTTBNNHNBTTNNNNHNN
NNHNBNNHHHTTNNTTTHNNTHNNNTNTNNNNNNNTTBHTTNNNNNNTNNHNHTNHHNNTNHTHNTNNNTNTTNNHTNTNNHNNNNNNNNNHHNNNHNNT
TNHNNTNBTBNHNNTTNHTTNHNTTTNBBTHTNNNNNBNNTHHNTBTNNBNNTNNTBNNTTNHHHNNHHNBTNNTNHTHTNNNHNHBBBTTNNNTNNHNN
NTNNTNNNNTNHTNNBNNNHNTTHBBNBNNNNNNNNHTHNTNNTNNNNNTTNHNTNNNBHNNNTNNNHTTNNNTNNNHTHHNHTNNTNTHNNTNNNBTTN
NHHBNHHNTHNHHNTNTNNTNHHNNBBNBHTNNHHNNTNTBNNNTHNNNBNNTNHNNNHNNBHNHTTHHTTNNTNHNBTNNHNHNNTTTHNTTNBTNHNH
NNTTNTNTTNNBHTTNNTNTBNNNNTNTTNTTBBHNTNNTNNHNNNBHHHTTTNHNTTTHTNBHBHHNNNNHTNNTNNBBNHTNNNHNBNNNNBNNHTBN
HHHHBNTNNHNTTNNNNNNNNBNTNNNTTTNNNTTBNTTTNHNNNNNNNNTHHNNHHNHNNBNNNHTNNHNNTNHBHNTNNTNNNNTHBNNHNTTTNNNH
NHNNNHNTNTTNHHNNHNNNTBTHNNTTHHHTNTBHTNTBNNBNBNNHNHNHBNNNNTNHNNHNNBNHBHHNTNNNNNTTNNNTNNHTNTTHNTNTNHHN
NNNNTNNNNHNNBNTNHNNBNHNTHNHNNBTHNTNBBHTNHTBNNTNTTBNNNTHNHNNNBBBNHNNNNHNNNNNNNNNNHBTNTNNTNNNNNNHNNNHN
HNHNNNNHTNNHBNHHNHNBNHTTBTTNNNBTTBNNNNNNHNNTNTNHNNNNBNTHTNTTHNHNTHTBHTBBHNTHNHBNNHNHNHHNNNTNNTHNNNNT
NBHNHHNTHNTHNNNHNHTBNNTNNNTHNNTHNNNNTNNHTTNTTHNNNTNTNNNHNTNHNTNTBNNNHNHNHTNTTHHNHTNNNNNNBNNHNHTTNTNN
NNTTNHNTNNNNHNHNNTTNNNNHTNNTNBTTNNNTTNNNTTHNTNBHNBNNNTNNTHNNBNNHNTTTNNTTNNNTTNHNHNNNBBNBBNNNNBHNTNNN
TNNBHNNBNTNNBBNTNNNTNTNTNNNNNNNNHTBTNHTTNNHNNNBNBNNHHNBTBNHNNHTNHNTNHHTBNNBHNHHNBHHTNNBNNTNNBBHHNNNT
NNTTNTHBTNTNHHHNNTNHNNNNHTHNTNNHHHTNBNTNNNNHTNBNNBNHTNBNHTNBHHNTHHNNTHHNNBNNTHHBTNNNNHNNNBNNNNNNTNHN
NNTNNTTHTNNHNNHNHNNTHNNNNBNTNNNTTHNTNNHNNBBNNHTBHTNNHHTNNHHTNNNNBNNNTTNNBNHTHTNNNNTTNHNNNNNNNNNTNNNT
