3122101121230113313232111011321313010302112312310111103112213112012133110231120231010312211112121311
1111111113112102111111132332111301113121111211312131310101321311310121133233211011311100332312233302
2311110221311111112311312013211111100113231231331121100112132323111013121212110321320112013011112101
2332321011131121232231332331223111301031221113102311111311111031321112111331333113132111130112111211
1013231321311212123111210123121333320121111332011313322131201211111101202321331112311113231232112310
2031003013302313110111002332131111013311023021121132123111131313313112303111010321100121333112222111
1122321002130131121111221012023031020313111122112331313312111333121111112111011231211233111011011221
2132011012202011231312032110100133110101312112311111120121132131220122111111133132113111331101211311
3322233111011212113113013112121121103201331211211101013131310121321113231311131322113121131113212113
0211131211011312111311311221332123030011013121223133201301012111031312101110112313123112110221110113
1113133302121311312031121211131312131012323120131130113011133121322120111220311111331113113102111221
2231122111311110112311313321111301221311211232332111111303111123010311021222113321311333001300131303
2211211101322322221231131011010121230112112111212131211131331330311103133310111112032012211311223211
3312023211333113011212133321333211313122321311111111101321112112113311013113132021221313112120111321
3111121011123102312223111221321210013222113001233210012223102131131311323131311221121111111210331113
0233120112111120111011132311102121110111331211311312111113110101131321133323111031110303133133131111
1102333012221110313111212223211212113121121113221111111102213323313113323303112101121132113113221111
1112321113121312312321001311121212111231103013211111122333112013131111100003132311121013111103303212
3131011103121223313332211111313211012131132120113113123101111111112223113313130232113011201231112133
0111112212112333231111110111213310122312232010231230211303311132101213133220110311112110111321331123
1211111211331111100222110101112311301111111133311111121231113132113113101113111113022232303212112111
3111100111112312031310100231211121013223221111230103211212131101132301110233310102111132203331310101
1131321211133111132333111331212133213223120313211212132111123312202301111111110131210113311220133101
1320031302130112131233211211113201122111321311311113110221311101011010011213213213020213233113213022
1310311211111111121323011222113103111113021112013111212121111121111123112311321132221131112210211113
2110122212223131112122311321111203101111023212131333311321100123111323221120103111113112012111111133
1233111322012111112110211110222120113101301113110221201112210213110331113000112311101111321102330112
1211011113212112021232321323331113313331113121121221312303132111131113322111212123311122113113232133
1111311220111321110112111131111112312121310211210231002132111111202132211313302312111212311121113332
1101120332211111121111112333311132212111300111131211211021113311233113131111223132301101311232112101
1111212322222113320131111022111101121001301311221210012112111113311111112111032011122010101320123301
1222121311111202302311033111220013221210231131111221113103112331123311120330323130101121330113001022
1231113202111321312111113032220110110122320130231111120111311021112111212321222311113132211111311211
1111332023022311133101111011201313113231311113111211011113132321131212231101121331232221012131213113
1113332311322012113122311201011213311111132333212221312211312112111311111310013112232211111133211121
2311111113112110113212333131111131321233121203212301313002110111103101321102331133112330210133311111
2131031021323100311012101111112311122133211203131113113011131321212321121111113111131011222101112111
1121311031333103213121132122231111102112203201213120221111111211123133131100302331031131212331133311
0210231111110111011203313121113111211201111011111111122031123111112101111112213212032131321123103011
0111121121101323211211111201221213121011132323122222111020311211131122223013220113121031211331201331
0100131213131222113111112323013213101312101032211223332021113120101232111113313101112111112303100021
2201321331322212312111331123333211120110311031212313321111232211121301211113321030111111111310111113
1231122110111111121112321123011132333110122011131111310003323311100133110110111232113111331331110100
3111110111111101121211311313001111131123211111111103223233103110132231312133331302321311211011121111
0012232011311011111120233133310121110222111310322212220232133313211132230011111133100110113011112133
1211132321311002111223010112211111031111221211311111122111110012211111301323331132100301111211302213
1121111110222133313311120123222122113021123113331311011312211313321211220121112233101231100313112301
0123101311131113101321113132111110131111213012211221011131211012311133130202301011111333231102111311
1111213112101111232211121001211231231311111212211123301131303221103032131222212211321111113031133120
1333023121220210312221011111112111110322131121331302300110113330211121011311201111201111113221013312
1312113213223202202113121121213011121313322311331111003110121101011121111201131131321312132331111133
3232112323113121001123302221031111321231111113130311110311211213210111223110120211111131321112110112
3111101112111130112312121110110211111312021011011311311101111231011112211213011121111120111221113110
1130302113011221233131111112013111321121112303221313321320010120213131111221111131010111232211101131
2221131030311332111211132102111013131311011121303121113111122111212332111111102111131110233111111100
1032213113132113212123111120130213011113121233223231211003322213213123010113113101102213332121130101
3220113112111111211311111210002321213311113313213113121212122211311113121301131023201303211120212133
3211333321122331121212101111202213111133113133113111221121121111311333111112111011113203012331103111
1323321112101131131311111112131231211312132131122102332131111212112103333111231112030201112333113221
3101231311221033032110201121031111313112111003101110032123211211311112112231311112223132123321131113
1331111001311111213010121331210233011211231111232112301123121231111132112200011122121211113112322132
2111131011213112310121111221131013121311111131101111111113103111112001330102120211111211321311101221
2101131111211101113031121121101301131211112113212012111212100131131131213121121311221211113001211121
1321111213111123122112323112110221111311031113111030231311213112122112102111123131130210112122211312
2111301201121031131121201112131121121111011111202111111132111101313113123220111001120111321210131211
2131121213202021122032211311111321210311313132333122113112313313113020112330001013211301231112012233
0332113211130311311331212311313211113311113313201320111111310111133112331013102212113213311122311111
3131233322301013210113101031122132113113301031131112200011121312211311231113211111110211100332211102
2113212121211012113102331123212123332011113322311031032301121212010331312111111121113131112123210121
2312131021131120033102323102322123122211212013113211101313322110121011101120123132221103101121111133
3112220031202231133110112012112312221331110321010001221121111120111113331120313322111013113311331131
1202331311221121121231213013112213112220120231101123113113112111113120331021113223311101032122111301
1132112123112221310211111112132121030121331223111321212331330311211111111222112111101112011211011222
1122331101211311213201332102121111211311110333111223211211021333213131221131131132121101131011013310
1131121233112113211112121111213132132121312312132321310310102313102210321133132013102321011011112113
1212113120102311121311123132121122331131123001111201113022121010100111203311012201111111111111113231
1320113111311212201112121222212021311121211131133111221021331131133232311013321103301020211321121312
1210121110131112022311121101131112133201112132311111100113331021313213122111202111121131121221013231
0311211113112130311033121110022101111322212231333221201111121111221111131313112311111021101111111301
0113113131111112231211121301133132211111131111231011122111333111330111311130023011132111111333121111
0212120101311131230311213111120303203012111131301101111300301113130011112222012111321111312132113111
2111121201131112112102211130111113211321111121211211231121132332101001201111130111123210311211211312
3323303302221213321101213222110321011102210100111231131210210121321313121213113111221131011211021111
3212112310131211231111021111233021133111211132311213113323311011221233323130113111111111121113112111
1122321111223113313123133121210212131211110103211321221312113013110121113113223111212111210121303121
1132121312131213213211021222111221231121321131011102212111102101111222113101121112333023013311113211
2232111113311111011112211112301103121311332103111211331232011133111121111213031121022101113130212131
3132120211203123111121101102120331101021122111331111132231301112111332111111322121011133133311311113
2313211321121223210131112031110310211213102212133111213122122213313013131110133110113202112121211232
1211022033012110110101131231311310212211110113122211111132112313321113111122123323311323222013011201
2023110211121321110301233121111322111221112131210013313311131111211111012200301110122321111123123300
0311312101121112111311321012121112121121131111121102111313112112322012033131301111121111111011120120
2111211101011111101313101211331011001101011111310111011101030121121121230111120310113333211111211222
1011131103111113111132311001011133131223120111212211001311131120121031323223112321102113210212221201
3202111012111231113111211313212111111122302111233211111121111102331112121133131311311132121221121312
2111133322113131121112101131111023121311112121101021121321312110110120130111332222311211122113101113
1111131121001233122303111013011111111121132321123312313213301112322111023113231112321223313301131210
3113011132311231130011010312113323122111011331131332300212110111312202210011312111111311313111212111
1111201311301111123210311111112311100301313311213123213120101121212231013233011103112131133211311121
2311111111213133112311331121112311231121111111131312221111020101103211311321110332131123133312232211
