NBNNHNHTHHNNNHTNTHNHHTNNNNNNNHNNNTBNNBNNNNNTNNNNNNTHNNNNTNHHBHHBHNNNHHNNHNTNTNHBHTNTTNBNHHTTNHNBNNTH
NHTNHNNNNTHHBTNNTBNNNBHBTHTTTHNNHNHNNNNNNNHNNNNNTBNNHNHNTTNHNHHHNNTNHNBHTNNNNHNHHHHNHTNBTNTTNNTNNHNH
HTNTHTBBNNNNNNBTNBTNTHNNBNTNBTNHNNHTNNNHBBNNTNHNNNBNBHHTTNNTNNTHBTNNHHHTNNNNTNHTHNNTTHNTNNNNNNNBNHNN
HNNHNTNHTNNNNNNNNTNNBBHNNBNHNNNTTNTHNNHTTTTNNBNNTNNNNNNBNNTTNHNNNNTNNNHNBTTNNNNHNHNHNNNNNTHTNBHNHTNN
TBNNNNNNNNBBTTNNNTNTNNNHTHNNNNNHNNTNNNHHHBNNNHNTHNTNNNNNBTNNTBNTBHNNNTNTTBNNBNNNHNHTTNHHNTTTTBNHTNHT
THNTNTNNTNNTNHNNNHHBNNTNNBNTBNNNHNBNHNNHHNTNNNHNNNNBNBNTTNTNTNHTNTTHTNNBHNBTHNTNNNNNNBTHNNNHHNTNTNNT
NNNNNHBTHNNBNNNHNHNHNNHNNHNNHHNHTNHNNTTBTNNNNNBHNNNTBNNNHBNNHTHTTNTNHNNTTTNNHTNNHTNTNNHTHNHHHNHNNTNN
NNTTBHTNHTHNNTHHNBNBNTTNNTNHHNHNTBNNNNTBNHBBHTNNBNBHHTTBNHNTNTHNHTNNNTTNNNNBNHNHNTBNNNNBNHNTNNBHNNBT
NTTTTTNTBNNNNHNNNHNNNHHNNTNTNNHBHHTNTNNNNNBHHNNTNBTHTNNNNTHBNNNNHHHNHTBHNTNNHTHNHTTNTNNHNNTNHTNNHTBT
TTTBHNHBTNNNNNNHNBBTTTTNTNNHNBTHNTHHNTNHNHHNNHTNBHNTNNNHBNNHBNNHNTNNTHBHNHNNNNHTTBTNNHTTNNBHNBHNNNNB
BHHNNTHBHNNNHNTNNHTHNNBTNHTNNHNNHTTHHTTNNNTHNNBBNBNHNHNNNNHTNNTTBNNNNBHTTNNHNNNNBHNNNHNHTNTTTNHTTHTT
NNNHHBNTTNNNNTNNHBBHNHTNNBHBNNNNHNBTHHNNNTTTNTTNBNTNNNTNHNTNNHNNNHHNNNHBTNTTNNTNNHHTNNNNNNNHNNNNNNNN
TNNNNTTHNNNTNNNNHBNTBNNNNTNNBNNNTNHNNHNBTBHHHNNBTNNBTBBNHTBTNTNHTNBNHNNTHNNNTHBTNTBNHBNTNNNHNNNNNTHN
TBHNNBNTHNNHNHNBHHHHHNTTNTNNBNHTNBTNHNHNTHNHNNTNHBHNTNHTNTTNNNHTHTNNBTNHTNNTNNHTNTNTNBNNTNBNHHTHNTNH
NNTTTBNNNNNTNTBHBTNBNNNNNNNNNHNTTNNTHTNNNTTTHNNNTTHNHNNNNTBHNNNNNNNNNBBBBNNHTNNNNBBBTNHTNTNHNTBNNTHT
NNNNNBTBNTNTBNTNHNNTNHTHNTNHNNTNNNHHTNHNNNHNTTNNTHNNNNTNHTBNBNNNTBNHTTNNNNTHNNHTTHNNNTHNHNHNNNNBHHBN
HNNNTNTNTHNHHTTNNNTNTHTHTNNHTNHBTNHBNTTHNNNHNNTHNBNNNNNTBHNNNNTNNHNHTNNNHNTTNTNHBNNBHNNBTHNNNHNNHTTH
BNBHHHNHBHNNBNTHTHNNBHTTHNHNNNHTNHNTHNNNTNNHNNNTBBHTNTHNNTNNTNNHNNTNHHNHHNNHTNNNHNTNNNNNNNNNNTTHNTHN
NTNBNNNTNBNNTNHBNNNTBNTBTTTNNNNNBHHTNNNNNHHNTNNNNNBNNTHHHBBTBNBHBHNHNNNTNNNNNNNTTBNTNNNNNNHHBNHTNHNB
NBNNNNTNTTTNTNTNBTNNNHNBNNTNHTNTNTNHTBNHHHHNNNNNNNTNNNTNTBBNTTNNTNNNHNTNBTBNNBTBHNBNNHTNNHNNHTNNNNHH
NNNNNNHNNNTHHBHHTTTHBNTNBNNNHNNNHNTNNNTHHHNNHNNTNNHHNNTNHNNHHTNBNNNNNNNNNHHNNTHNNNNNNHNNHTNNNBTNNNNB
HHNTHNHNNHNHNNHTTNNNNNNBNBBHNBBNNNNHTNBNNNBTTNHBHNHNNNNHNTNBTNNNNHNNBNNHHHHNTNHTTHHHTHBBNNHNTBTBBNNN
TNHNNHNTNNNNTNNNTNNNNTNNHBNNNHNNNNNTNNNHHTNHNNNHHNNNTTTTNHTNNNTHNBNNTTTTHBNNNNNNBNNTNNNBNNTTNTTHHNBN
TNBTHNHHNNTNBTHNNHTHNHBNNTTHTTNNHNNNHTTHNHNBBHNTTNNTTNNNBTNNTNNNNNNNHNHTTTHHHTTTHNTTBTNTHNBTNNHTHBHN
NNNNHNNTBHNNNHTTBTTTTHNTNTNNTTBBNNNTHHNNBNBTNNNHNHBNBHNNNTNHHTNHBNHTNNTTNNTNNTTNNNHNNHHBHHBTNNNNHNNT
TTNNNTTNBTBNHTTTNNTNNHNNTNNNTTNNBNTNNTNHTHHNNHHNNHHTNNHNTNNHTHNTNNTHNNTNTBNTBNNHNNNNHNHNHNTNBNNHNTTH
NTHNTNNBHNNNNBTHTNHNTNNHNNNNNNNBNTBTBTNNNNNBNTHNNNHNNNNBTHNNNNHBNNNTNNNNTTHNNNNHNHNNNNNBNNNNHHHNNHHT
NTHTHNNNTTHNNTNNTHTHTHNHTNTNHNHNHHNNNTHNHHNNNNHNNHNNTHBTHBNTNTHNHHTTNBTNHHNNNBHNNTHHNTTNBNHNBTTTNHHN
NNHHNTNNNTNNTNNTNNHNBTHNTTBBHNTNNNNNTTBTNNTNHHTNNNNNNNHHHHHNHNNNBTHNHHNNNHTHTNTBBTNHNNTBNNNNTBNNTNTN
NHHBTTBTNNTBTNBHHNNNNNTHNTNNHHNBHHNHNNTTTHBNBHNNTNNNHTBTTNTNTNNTNNTTNTTBBTNBNNNHNTTNTTNHTNHNHNBBHNNN
THBNNNHTNNNHNNNBNTHHNNBTBNTNTNNNTNNTTBHNTHTNTTNNNNBNHNNTTBHBNBTNBHNNTNNNNHTHNNNTTTNNNNHHHNNNTNBNNNTH
NTTNBBHNHNNBNNTNNBBTNNHNNBNTTNNTHNNHNTNBNNBHNNNTNNNBBNBTTHNNBTNNNTNHNNTNNNHTHNNNNHNTNTNNTNNNNTTHBNHN
NBNTNTBNTTNNNBNHNHNNNNNNNBTNTBNNNTHNNBHTNTNTTTHNNBNNNTTBTNNHHNBTNBTNNTHHNNTHHBNNBNHHNTNTNNNNTBTNHHHN
NTTNNHHHBTNNBHNHNHNNNTNNNBTTTNNTNTNNTNNHNTHNNNNTNNHTNHTHNNNTTHHNBNNHTNNNNNTHNHTNHHTTNNNNHTTTTTTTHTTN
TBNNTNTNTTNNHNNNNNTHNHHBNNHNBTBTNTTNTNTHNTHTTTNNHHNNHTHHNHNNTTHNHNHNHNHNHNTNNNNNNTBHHNNTHNTNNNNNTHHN
NBNBNHNTNHHNNNTTNTNHHBTTBNTTHNNTHTNHNBNBHNNNTNTNTNNNTHNTTNHNTNNNNHTHTNHNHHNNNBNNTNNHBTNTNTNNNNNHNHHB
NTNHHTBNNNHNNHTTNNHTTTNTNTTNTNNNNTHNTNHTNBNNNNTTNHTNHTHNTHNBNTTHNTNNHTHTTTHHNNNNNTNNTNNTTHNNNTNBNNTN
NHNBNHNTTNNTHNHNHBNNHHNNHTHTNHHNHTNHNNNNTHTTNHTTNNNNNNHNNTNHTTTHNHTTNNHNNHHNHNHNNBNBNHNHNNNNNNNHBNNT
NNNTTNTNHHNNNHHHHNHTHHHTTNNNNTNBHHNNHNTTTNNHBTNBNNNNNNTTHTNHTNHNTHNNNNHTTHHNNNNNNNNHHNHNHHHNTHNTHBTB
NNHNNNHTNNTTNNNNTNTTNNNTTHNNHTTNNNBTBNTNNNHNHNNHHNTNHTTTBHNNTNHHBBNHNTTNBNNHTTNNTNTNNHTNBNHNNNNNNTNN
NTNHHTNTTHNHNTNNNTNNHNNNNNNHNHNNNHTNNNNNNNNNHNNNNNTBTNNTNNTHBNHNTNBHHNTNNBNHHNNBNNNTNNNTHNNHNNNBNTNN
THBTHTNNTNNBTNHTNTTBHBTNNTNTBBHNTNNNHNNNNTNTNNTNNNTNTTHTNTBHHBTNBNNNNTHTNHNTBHTNBNNTHNHHTNNHTNBNBHHT
NNNNNBNNNTHNTBNNTHTNNBHHHNHHHNBHTTNHBNHTHHNTNTNNTTTNHBHHNNHTNBNNNNNHNHTTTBNNNHNTNNNBNNNHNNHNNNTHHHTN
NNTHNNHNHHNHNHBNHHHTNTHBTTNNNNNHTNNNNNNHHNNNNHHTTNHTNNBHNNNNHHHTNTTBNTNTNNNNNHHNNHTNTNNTHNHTTNNNHNHN
NTTTNHHHNHNNHHNTTBBNNTBNNTNBNNBNNTHTTNNNTNTHTNHNNTNTHNHHHNNHBNNNBNNHTNNNNHTNNTNNHNTNHBNTTNNNHTNHHHNT
NTHNNTHTNNTNBNNBHNNNHBNHTBNNTNTNNNNNTBHNNHNHHNBNNHNNTTNHNHTNHNHNNNTNHHNTTHHNBTNTHNNNTNHNNHBHHTBHNBNH
THTNNBBHNNHTNNNBNNTTNNNBNTNNHHNHNTNBHNNNNHHNNTNHTHHNTTTTNBNNNNNNHNBNNNHTNHTNTTTNBNNNNBNBNHHNNBNHNNTT
NTNTHNNTTHTNNNNTNBNNTHNHNTNTHNNNNNNTTTBNTNNNNNNBTBNTHBNTBHHHTTBBTNTNHTNHNHNBBNHNHHTNTNNTBNNTNTTHHBBN
BNHNTNNHHTBTNTNHHNNNBNTNNTNTHNBNNHHTTNBNNNNNNNTBTHNBHNHHBNBBNNTNHNNNHTNNNNBHTNBTHNHNNHNNTNTHNNTHNTBN
NNTTTNBTNNTTBTNHNNNTNHHNBTTTHTNNHNHBHNNNNNTHNTNTNNHNNHNHNNTNTBNNNNTNNNNTNTHNHNNHTNHTNNNNTHTNHBNHHNNB
NTHTNNHNTTHTNNTNNTBHNTTBHHTNHNHNNNBNHTNTBTTNHBNNTNHNNNHBTTHHNHNTNHTNNNNTTNHHTHTNHBHNNNTTNTTNBNBHNHNB
THBHTNTNNNTNNBHNNHNTNBTTTNNHHNNNTNHNNNHTBTNNHNHNHBHNNNNTHNNHTNNTNHNHNTNNNTBNHNHNBHHHNHTHTNNTNNBTNNHT
NNNHHTTBTNHBBTBHTNHNBHNTNNTNBNNNHTHNNNNTHNHNBHHNNNNHNHNTTTNNBNHNHNBTTNTNBNTTTTNNNTNTNNTNNNHNHHTTNTNH
HNNNNTTTNTNTTBNHHTBTHNBTNNNHTNHHNNHNBBBTNNNBNTTTNHHNBNHNNHNNHTBNNHNNNHNTNNNNNNNHNHNNNNBNHTNNNNNNHNBH
BNNTNNHHNNHTHHNTHNNTNNHNNTNHNTNTHTNHHHHNNNNHNNNHTNHTHBNBNNNTHNHHHNHBBTHHBNHTNHNTNHNNNNNHNNTNNTTHTTHH
NBNBNNHNTNNNNNTNHHBNTNNTBNHHHNNHNHHTNHNNNHHNTNHNNNHHNBNHBNNNHNTTTTHHNHNNNHTTNBHTNHNNHTNHNHBNNNNNNTHN
NNNBNTNTNNHNBBNNNTNNHNNBNHHHNHNBHTNTNNTTTNTNHBNHBTNNTNNBNNNNHNNHBNNTNHNBHBHNBNNNNTTBHBHHHNNBTNHNHNBT
BBHHBBBTHNNTBHHNNNHNNNNTHNNNNNNHNTBNHNNNTNHNNBHTHNNHHHTBHHHNHNNTTBNNBNNHNBNNNHHNNTNNNNHHNNNNNHNHTNTN
NNHBHBHTNTBNNNNNNNHHHNNHNNNHNBNTNHNHHNHNNTNTBTTHHHNNNNTBTNTTTHTNTNNNNHNTBTNNNNTNTHNNBHHHHTTTNHNTNNNN
BHNNHNNNNHNNNTNTBNHHNNTNTHNHHNHNNNTNHHNNNHNTNNNNHNTHNTNTNNHNNTNNNHHHTNNNNNNNNNNTNNNHHNHNTNNHNNNTBNNN
HNNNTHHBNNTNHHTHHBBHNTHNTNNNNBHNNHNBNTNNNNHNNNNHHNNBNHNNBTTNNHHHNNNTTNNTNTTNNNNNBBHTTHNNHNTNNBHNNBTB
NNTNNTNNNBTTNNTNNNNTHNHNTNTNNBTTNTNHNTNNTNNTTNNTTNNTBTNBNBHTNNHNNNNHHBNHNNTHNTHTTNNBNNNTNNHNTTNNNHTH
TNNHNNHBTNNHNTHNTNNHTTTNNBNTBHNNNHHHHNNNTNNTBNHHNHTHBNNTTNBNNHNNHNTNNNNHNNBHNNNNTBHHBNHNNNNBHNTTNTTT
NNNTNNTHTNNTNNTNHNBNNNNNTHNNTNBNNNHNTNHNHTHTTNNTNHHBHNNNNHTHNHNTNNHHTNHHTNHHBNHBHBTBNTHNNNNNHNNNBNNB
HNTTTNHHNNNHNNHTNTHNBNNNNNNHNHTNNNNHNTHHNTBHNNNNNBTHTNTTNBNNNBBBNTHHNTNBHNTNHNNTNNTNNNNNNHNBNTNTNNBB
NNTNTNBNTNHTBNTBHNTHBHTTNTHTNBNHHHNNTTHTNBHNHHNNNHNNNNBNNNTNNNNTTBBNNNBNBHTNNNHNTNBHBNNHNNTNNHNHHNNN
TNNNHNHTHNTTTBNNNNNHHHNNNNNHNHTNNBNHNTNNNHHNHNNNNHHNBHNNNTNNTNTNNBNTNTHTNNNHTTNNNNTTNHBNHTHHNNNBNBTH
HHNHNNTNHTNTHNNTNTHHNNNNNTHHNBNBNNBTNNBTBBHHNHHHNNNBBHTNNNTNTHHNTTNNTNHNNTHNNHHTTNNBNBNNNNBHNBTTNTNN
NTNNNNNTHNTTNNHNNNBHNNNTNBNNNNBBTNNNNBTNBHNNNNTTTNBNBBNBBHNHTHTTNBTNNNNBNNTNNNNNHNNHNBNNTTTNBNNTNNNT
HBTBHBBTTHTNHHBNNNHHHNTBHNNBNTBNNTNNNNHNNNNNNTBNTHNNNTNTNNNBNHHBNNNNNTTTNNHNBHHBNHHHNNBNTNNBHTHNTNHN
THTNTBHHTNNHBTNBNHHNHNBBHTNTTTNTNHTNBTNNNTBBNNNNNNNTNNNNTNNNNHNTTBTTTHHNNHHHHNHNNNNHNTHNTHNNTNNNHBNH
NNTTNNNHHNNNNBHNNNHHHHNNNHHTHBTHTHHHTNBNNTBNHNHTNHHTNHNNTNTTNNBBNHHHNBBNTNHBNNNNHNNTHBNNNNNNBNBNTNNN
NBNNBNHNNTNHHNNNNBNTHNHNHNNNTNNNNNHTHHNNBBTHNTTBHBNHTNNTTNNNNBTBNNTNHNNTHNHTNTNTNNBHHNNNHNNHHNHNNNTT
NNTBHNBTBTHNNTNNNTNNNNBNTNNBNHNHNNNNBTTBHTNNNNNNHBBTHTNNHNNTNHTNTBNNNNTHNBNNNHBNHNNNHHTBNNHTNHBNNNNN
NNNHTNNNHNNHHNTTTHTNNNTNNBBTBHNHNNHNNHTBHNNNNTNNBHNHBNBNHNHNNNNHHNNNNNNNTNBHHNBTNNNHHTNNNBNHHBNNNNNH
NHNBNNHNNNNNHNHTNNNNHNTHNBNNNHNNNNBTNTNNNTNBHBBTHNNTBNTNHNBNHTTBBNNNTNHNNNNHHNNNHNNHNNNNNNNHNTHHHNTN
HBNTNTNTHNTTHBTNTTHNTBHNNNTNNNBNHNHTBNNTNTBNNTNTNHNNTTNNNTHNNNBNTHTNNNNNNBBNNNBHNNNNHNBHTTNBNBTHHTHT
THNNBNBNTTTHHNNTNTBNHHNHHNNTNNHNNHHTBNNNNNTNHHNHNHNHNBHNNNNNHNNTNNNTNNNBHHHTTNHTHHNBBNTHNNNHNNHNNBNH
TNNHBNTTBTTHTTNNHNHBNBTNNBHHNTNNTHTTNTTTHNNHBTHNNBHNTHNNNHNTTTTNTNBNHTBNNTNBNNNTTBTBTNHNHNTTNTBHHTNH
NTHNNNNBNTHBHNHNBNBNNBTNNNNNTNNNNNBBTTNNNNNNBTHHBHTNNNNTHHNNHNNNNNNNNHNNNNNNTHNTNNNHTNNNNHNNHHNHBNNT
NTBHHNBHBHHNNBNHNNBTHHHHNNHNTNHNNHNTNNNNHHTBTNNNTNNNNHNNTNNNHNTBTBNHTTNHNHTTNNNTHHNTTBNNNTHNNNNNHNNT
THHBNNNTTBNNNBBNHHBNHNHNTNNNTHTNNNNNTBHHNNNNNBNNNNTBNNNNNTNNNNHNTHTBNNNTHTHHHNHTNNNNNHHNBNNNNHNNNNHN
HHNBBTNNNNNNHTTNHNNTNTBNTTNNBTNTNHNNNHBTNBNTNTBTBHHBHNTNHHBTNNTHNBBNNNHNHHHNNTTNTNHHTHTBNNNNHTNNHHTT
TBNNBHNNHNNNNHNHTNNNTNNNTBHTNHNNHNNHTNHTNHNNNTHBHTHNNBHNNTTHTNNTTNNNTHNNNNNNNNBNTBHNBNNNNNTNNBTNHNTH
TNNTNTNNHNTHNNBNNNNHBTHHNNHTNHNHNNHTNNNHNHBNBBTHTNTNBNHTTTBNNTBNNBNTHNNNNNTTTNNNNHTNHTNTBNNNNHNTNNNN
HBHTNHHTNNNNNHBNHNNBTNNBTBNHBNNNBNHNTBNBNBHTBTHHBTNNNNNNHBNNBHBNNHTNNNTTHTNNTHNHNNNNNNHNHNNNHTBNNTNN
BHNNTHNHHHNNNHHNNNHHNHNNNHNHNTBNNNNNTNBTNNHNHNNNTNNBHHHNNNNNNNNNNNHTHNNNNHHNHHTNHNBNHHHHHNTBNNBTTHNH
NNBTHNHTTBHHNNNNTNNNHNNNHHBNNNNNNHNNBTBNTNNNBNTHHBNHHNNBNBHNNNNHHNBBNNHBNHHNHTNNNHNNNBBBBNTHNHNNBNTN
NHBTNNNNTNTNTNNTNNHNNTNBHNNNNNTTNHHHHTTTNHNTNNNBTTBNTTHNHNHNBTNNNTNHHHNNNHNTNNNTHNNHHHNNHTTHNNNBNNBN
TNNHTHHHNTTNNNNBTBNHTNHHNHNTBTHNHTNHBNNNNBTHTNNTTHNNBHHHNNHTBTTTTHNNTBNTNNHNBTHHNHHTNNHNTNBTHHTTHNNH
NTHNNNNNNNNNBNNBNHNBTNHNNTTNHTNTNNNTHTTBTHNNTHNNNNNNTNBNHTTHNNHTNNTNNNNNNHBBNNNTNNNNNBNBNNBTHNHBBNTN
NTTHNNNHTNHNNHNNNTNNNNNTNTTNNNNHHTHNTNNTBNNNNTBBNNNNNTTNTNHNNNNNHNBHNNTTHNBNBHNBNNHTHNHTHTTNNNTHNHTN
HNTNBHNBHTBNBNNHNNBHBTNNBNNNNNNNBHNTBNNHTHTBHHHBTNHTNTBHBTHTNTNTNTHNNNNNTBHBTNTNTNHNNTNNNNHNBTBTBTBN
HNNTNNBBNNNNNHHHTNNNNTBTHHHNNNNNNBBNNHTNNHHNNNTBHNBHTTBNNNNNTBNNNNBNNNNNNNNNNHTNHNBNNNNHBHHHTTBTNHTH
HNNNTNBTNBHBHTNTNHHNTTNNNNNNNNNNNBNHNNBNNNNNNNTNNTTTTTNHHNNHNHNHHTTNTBBBHTBHBTTNTHTNNNNTHHTNHBNNNHNN
NNNNTNNNNNTNTNNHHNNHNBBTNTNBTNTHNBBNNNNHNNHTTNBHBBTHNTNNNTTNTNBBBNHBTNTHHNHTHNNNHBNTNNNNTTNNNNTNNNHN
HHNNHNNNHTNNNNHBTNNNNHNHNNNBTNNNNNHHNTNNNBNTNNNNNNNHHTNNHNBHNNNNBTTNNBTNNHTHNHNHNNNHNNNBNHNNBHNBBNHN
NNHNNTNNNTTNHNNHTTNBNNTTHNBHTNNNHNHBNNHNTTBHBBNNNNTNNHNNNNNNNNHTHHNNNHTNNNHBHTNHNNNBHNNHNHNNTBNHNNTH
HHHHTHHBNNHNNNNNNNNNBBTNNNNHNNTNNNNNHHHHHTHNNNNNTNTBTNBHHNBNNTNNHNBNNNTNNNNNNTTNNNNHTBNNNNNHTTHTTNHN
NTHHNNNTHNNNTNTTNBNNTNNNHNBNHNNTBHNHBHNNBNNHHTTNHNHNHTTNNNHNNTNBNHNNTNTBBBBNNHHHHBNNNNNNNNNNHHNTNNNN
