NHTTHTBNNNHBHNNNNNHTNNBNHHNNNNHNNNNTTNNNNTNNNNNHNTHTNBNNTNNHNNHHNNNNNBTNHNTTHNHTHTNNTBNTNNBNNNTTHHNN
NTNHNNNTNNNNNHNTTNNNNNNNNTHHTNNTNHHHNBNHBHHTNNHTNNTTNNHNNNHHNBTNNNTNNNHBBBNNNBNNHNNHBNNNBBTNTHHTNNNN
BHNNNHTNNBTBTNHNNNNHNBHNNNBHBNTTNHNNBHTHNNTHNNHNHNNNHNNTNTTTTHNNNTNNTTHNNNNTNNHHNHHTBNNNNBHBBNHHNNTN
BNNTTNNTNTNNNHNHBBNHNNTNTHNNNHHBHHNNNTTHNNNHNNNNBBBNNNBNBBBTNHNHTBNNNHNTTBNNHHHTBNBNTHNHNNNNTTHNBNTN
NHHNTNNTTNNBNTNNNNHHNNNHNNTHHNNHHNHTNNHNNHNBNTTBBHNBBBNHNTNNNHTNHNNNTNNNNNNNHTBBTHHTNHTNNNNHTNBNTNNT
TNHBNTHNNHNNNNTNNNTBNHTHNNTBHNBNNNNHHNBNNNHNNHNNTTNTTHNNNNNHHNHNNTNNBBNNHNNNNHNNBTNHNBHNTNNBNNTHNNNN
NNNNHTNNBTHTHTNHTNHTHNNBTTHHHTNBHNTTNNNNNNBNHHNNNNNBHTNTNNNBHBNNHNTHNTTHTBTHNNNTNTNTBHNHNTNTBTTNNNTN
HNTNNHNNNNHNNNHTNNTTBNBNHNNNNNNHNNNTHTTTTTNTHNBTHHNHNNNTNNHNNHTNNTBHHNNTNNTTNNHNNHTTTNHNHNTNBTNTTTHN
TNBBNHNNNNNTNNTTTNBTTTNNNNBHNNNNHNHNTNNNNHNNNNNTHNHTNHNNNNNBNNNNNTNHNNNHHTNNTNTTTHTTTTNNTBNTHNNHTNHN
THNTNNNNNHNHHTNNTNHTNBNTTNHNNNNNTHNBNNNNHTHNTHNNNTTTTNNNNHNNBTTNNTHHNTNTNNTBTHNHNNHTNNTNBNNNTHHBTNNT
HTNTTNNTNNBNHHNBNTTTTNTNNNNNNNHNNTNNBTTNNNBTNNBHHTTHNNNNHTBTHNNNNNHBHNNBNHNNNHHNNBTNHNNBNBNHNHNNTTNB
HNNNNNTBTHTNNBTHNHNNNNNNNNNNTTHNNBNHNBHTBTTTHHHHNBNTTNTNNNNNBNNNBHNNNNHNHNTNBTNNBNHNHNNTHNTHNTNNBNNT
NNNNHTNNNNBTNNNTHBNNNTTNNHNNNHNNNNTNNNHNNHNTBTNNBNNNTNTNHBNNHBHTNHBHHHBNHTTBNNHNNTNNBTNNTHNTNNNTHHNN
NTNHTNBNNNNNBHTHTNNTHHTHHNNNBTBNHBTTNHTBTBNNHNTTNHHHTTTTNHHHHBHNNNNNBHNTTHTTNBNTNNTNTNTNBNHNTTNNTNNN
NNNNNNTTNBBNBNTNTTHNBBNTNTNHNNNBHHHHBHHHNTNNTBNTBNBNNNHNNNBNBHNNNNNBTNHTHNTHNTNNHTHBTNTBTHNNNNNNNHBN
NNTNTHHTHNNTTBBBNTNHNNTNTBNTNBTHNNTNNNBHHNTNNHBHNHNNNTNNNNNTNNHHNNHHNNTHHNHBBTHHHTTTHTNNHNNNHNNHNNNH
BNNTHHHNTHNNNHNTNNHHNHNHTNNHHHNNNTTNNHTNNNNTNBHTTNHTTHNNNBNNNNNNTNHTNNTNBTNNNNTTHNNNTBBNNNNNNBNNNBNT
TNHTBTHNNHBNNHNNNTNBNNNNNNTNHNNNHNHNNHTTTHTNTHTHHHNTNNTNNTHNNTHNNTHHTHHNNTNTNBNBNNNTHNNNTHTBNBNTNHTN
TBNHNBNNHBHNHTNNNNNHHNNNBTNBNNTHHNNNNHHBNTNBTNTTTNBNHTNTNTHTHNTNTBTNBNNNNNNHNNNNBHNNNBBTHTNHNNTNNBBN
HNNNNHTNHHBNNHNHTBHHHBNTTTNNNTBTHTNHNNTTHNNBNNHNTNBBBHNNTTBNHTTTBNTNNNNHHNNNNNHHHBNNNNNNNNNNTNTHHTHN
NTHNNNHNBNBBTBHNHBNNHBNNHNNHHNTNNTTTBNNTHHTNNNNTBTNNTNHTNBTTNNHNNNBTNHNNHHNNTNNTNNHHBBNTHNNBHNTTNTNH
NNNHBNNHHBNBTNHHBHNNTTNTNNNHNBTTHHNTNHHBNHNNNTBHBNTNNNNNTNNNHNNHNNNNNBNTHNBNBTHHBNNNBNNBHBNTNNNTTNBN
NNNNNNBNNNHNNNHBHNNTHBHBNNNNTNNNNTNHHNHNHHHHTBHNNHHNNHNBBNHBBNHHTNHHHTNNNNNTNHNBNTHNTBNNHNTNTHHNTNNN
NHNTHNNHTTHTHHTNTNTBNNTNNBNHNNHTTTTHBNNNHBNHNTNTHHNTTNBHHNNNTNNNBBNNBNNHBNHNHBNBHNTNNNNTBNHHBNHHTHBN
TTNTNNNTTNHHNNNNNBHNTNHNNNNNTTBNNNNHHHNNNHNNHNNNNTNNTNNNNNHBHNNNNTNHNNNNTNNNBHBTNNBHHNBNNNHNNNNTNTHT
BHNNHNNHTNNNNTNTNNTNHHNHHTTBNTBHNHNNNNBNNHNNNNNNNNNHHTNHNHTTBHHBHNTHBBTHTNHHHNNNTHNNNHNBNHTBTNNNHNHT
TNNTBTNNHNNNNNNTHNNBTNHNNTNNNTNHNHNNTTNHBHNTNHNNHBNNTNHTNTHBNBBHBNNNNHNTNNNNTNHHNNBTTBBTTHNNBHBHNNHT
NNNNHBTTNNNNNTNHNNTHTBNTHNNHNNTNHTNNNNHTTHNHNNTNBNNNBHHNTTNHNNBNHTNNTTNNNNNTNHHHBNNNTNNNNNTTHTNTNNNN
NNHNTTNNHTHTHHHBNTNHBNTHHBHTNNTNTHNHHNNTNBHNBHHTTTHTBNNNBTNNHNHTBTBNNTNHTNNHNNNNNTTNHHNNTNTTNTHHBTNB
THNTTNNHNNBNNNTTNBNHTNNHNNHHTNNHHNTBNHTNNBTNNNNNNHHTNNNTHTBBNHNNTNTNNTTNHTNNNNHNNNHNHNNNTNNNHTTBNNNT
NBBHHNTHTHBHNNTBHNHNBHHHNTHTHNBNNNBBHHBNHNBNHTHHNNBTBHNNTTNNNNHHNNHTHNTTTNTBTTNHTTNHTHNNNTNNHNNHHTNN
HNTNBNHHBNNTNBNHTTNTNTTTNNNNNNHNNNTTNNNHNBNNNHHTHTBHBHTTTNTNTNNNNNNNTTBNTTNNTNNNTHTNHNNNTTHNTNNNNTNT
NBNNNHHHNHBTNNBHNNTNNHNTNHTNBHHNNTBNTNNNHBHHNNHTNHNNTNNNBTTNBNHNTTNHTNNBNNNHNNTNNHNNTTNNNNBNNNHTTHNB
NTBTNHBNTTNTNTTBBNBNBNBNTTNTNNBBHHNTNHNBNNBBBHNNNTNNNNHHNBTNBNNNBHTNNNHNHTBTNNNNHNNNNHHHHNNNNTNBHBNH
NNNNNHTHNNTNTHTBHTNNTNBNHNHTNNNHNHNNHHNHHTTBTNHBTHBNNBNHNNNHBTNHNNNBNNNNTTHNNTNNTNNNNNHHHTTTHHNNNTBN
TNHBNNTTNNHNNHNNNHNTNHNTNNHNBTHNNTNBNHNTNNTNNTNHTBNNTNNTNTNHNHNNHNNNTNNHNHTBBNNNHNHNTBHNTTNNNNTHNNTT
NHTNBNNNHHHHTHTNTNNHHNNNNHNTTHTTNNNBTNBNNNNBTTNTHHNNBHNHTTBBNTHNNNNHNBNNHBNNNNNNTNTBNNTBNHNHHHHTTBHN
NNNBBHHBTNNTNTNNNNTBNNBTNHBHNNNNNHNHHHHTHTNNTHTNTTTTNBHHTTTHNTHNNNNNNHBBNNTNNHTTNNNBHTNNNNNTHNHNNNNN
HNNTNTBHNTTTNNTHTTNNHNTNNBNNTHHNNNBNTNNNNHBHTNHBTNNHTNNNHTHNNNHNHBTNBNTHHNNBNNNHNNHNTNBHNTNHNNNHHNTT
NNNNNHHTNNNBNTNNNNHNNNNHNHNTHNTNHHBTTNBHNNTNTHNHNHTNNHTNTNTNNNNHTNHBTNNNHNNBNBNNBHNHTHNNBNNNNNTTNBTN
NHHHHHTHNNTNTTHBTNTNBTTNNNNHTTNNTNNNHNNNBNNHTHBNNNNHNNHTTNHBTNTNNNNHNNTNHBNNHTTHTNNNTNBNTHNHHNNTTNHN
NBTHNBBHNHTNHTHHNTNTNHBNTNHNBNNTNNTHTNNTTTTHTNTTNNNHTNHTNNTNNNNNNBHTBHNNTHHNTNNTTNTTNNHNTNNHNTNHNNTN
BTNNNNNTNBTTHNBNNNNTNBHTTHBNNNTBHHHBNNNNHNBHNBTNHNHNBNNHNTTNNHNTNBNHNNTHBNNNHTHNTNNTNNHTHNHHHNNNTBNT
NTNTNHNHNTHNBNTTTNNNNNNNBNBNTHNNTTNHNHHHNNNNHNHHNHNNHHTBNNTTBNHHTTNTHNNHHNHTHTHNNHNHTBTNNNNNTNNTNBNN
TBHTHHBNNNTTNNNNHHNTNTNNTNNNNHNTBTNNNTNNHTNTNNNNHNHTNNNTNNHBTHTTNHHNHNHHHNBNNNTTBTNNTNHNNBTHHTHNNHNN
HNNTNBBBNNTTTTBTNHNNBHHNHBNTNTNBNHNNNNHBBTTNTNNNNHNNNNHHHTNTHTNNNTNBBNBTHNNNTHHHNHNNNHTNNHTHNNNHBHNB
NNNBHTNNNHNHNNHNHHHTTNNNNHTHNNNNNNHTNHNNTNTNNNNNNTNTHHNBBNBHTNHNBHHHHTTNNTNNNNHNHBNTNBTNBNNNTNNBNNNT
TTHNNNNHNTNNNNTHNTNNTTNNNNHHTHBTNBTNBHNNHTHHTNNBNNBBNNNHTNNNNNHTHNTBNNNHBHBTTHTTNNTTTTTNNNHNNNTBHNHN
HNNHNNNNHNHNNNTBNNHNNNBTBNHBTNHNNNHTNHHNTTBNNBTNTNNHNTNTNHNBNNNNBHNNBNTNNHNBNHNNTTBNNBHNNTHNTNNNBNTB
NTHHNNNNNTNNNTBNNHBTHNHNBNBHNNNBNNNNNTNTBNNNNHNHTHNHTNNNNHNHHNBHNNNHNNBHTHNNTBHHBNNNNNNNNNTTNNNNNNNT
NBTTNTNNNHNNTHNNHNNBNTHTBHBBTBNTNHNNNHHNBNTHNTNNNNNNNHHHNNNHNNTBBHNNHHHTHHHTHTNNTNNNNTTNTNTNNNHNNNNN
HTTNTNNTNNTNTNNBTTNHNNNNHTBTNNNNNHHBNHTNNNTNNNNBTNNHTHNBTTNHBTNNTNNTNNNBTHBTTHNNBHTNNNTNTHNHBNNTHNNN
NNHNNNBTTNNHBBTNNNNHNHNBBNTTNNTHNNNNTBNNNNNHNTHNNHBNNHTHTNTNTHBTNBNBNNTHHNHNTNTNTNHHNNNNBBTHHHNNTBNN
NTTBHNHHHTHNHHTHTNNBHNHHHTTNBNNNBTNNNNHNHNHNNNHTNNNNTNNNNNTHNNNTHTBNNNTHBNNBNNHNNHTNTNHHNHTNTNTNHNBN
HBNHNBNNNNHBNNBNTTNHNNTNHNHNNNNTNNNBHBTNNTNNNTNTNHHNNNHNNNTHNBNNHNHNTHNTBTNNNTHNNTNHHNHNHHNNHNNNNNBT
NTNBNTTBHNTHNNNHNNTNNHNTHNNNHNTHNBHNNBTNTHNNTBNNTNTNNHNNBNBNHTHTNTNNHBHNNHNBNNNNTNTNHHNNTNHTHNNNTNHN
TTNNNTNHTTBNNTNHNNTTTNTNNNBHTBHNBHHNTTNBTNNNNNNNNBHTBHNNBBNNHNBHHNHTHTHNNNNNTNNTNTNNTTHNBTTNHHTNNNBT
TNNNTTTNHNTNNHHBTNNNTHNBHNNBTNBNNBNTNTNHNTBNTNNNNNNHHNHNNNNTNNNHHTHNTNNTHTTNTTBNNTNNTNNHNTNNTTHTTTNN
HNNNNNTNTNHTNBHTTNTNNTNNNBHTNNNNNHHHTNHHBHHNNHHNHBNTTTNNHNNBTNNBNNNHTNNNNNNHTBNNNTTNHTHHHTHTTHHNTHBH
HNHNNTBNNNTNTTNNHBNHTTNNHNBBHTTBNTNNNNNNNHNNNTTTTNNTTNNNHNTNNNNHNNNBHNTNBHNTTHTNNBHHHTHNTTHNHHHNTTHN
HHTHTNTTHHNHNBTNTTTNNHNNNHTBNBTHHNHTTBBTNHBNNTTHTHBNBNHHHTBHNNTTNTBHNTTNNNNTNNTNNNTNNHNNNTNNHNTTNNNH
HHNNNNHNBNNNNTHNNNHNHNHTNNHNNHBBNNHNNNHBNNBBTNNHNNNTNHBBTNNNNHHHNHNHBNNTNHHNHNHTNTNTHNBNNHBHNTTTTBBN
NTTNNNTNNNNNTNTHNTNNTTHTNBNTNHTBHTNNNNHHNNTHNHHHNHBHNNNHNNHHHNNBNTHNTNNNNNNTNNTNNNNNTNHHNNHNHHNNNHHN
NTNHNHHNTNHNTNNNTTNHNNTNTNNNBHBNNTHNNNNNNHNNNNTBNNHTNHHNHNTTNTBNTTHNNNTTHHNHHHNBHNNHNNNNNTNNHHTHHNNH
HTTHBNNNNNNTNTNBNNNBNNHNNHNNNNBTNNNHTHTNHNTBNNTNNTNNTNTNNNHHHBBNBHTHNNTNNNNTNHNBHNTBHNBNTNNNNNNNTNNN
NNNNNTNHTTNNNTNNNNNNNNTNTNHHNNNBTNNTNBNNTNBNNNNBTNNTHTHNNTNHNTBHNTNNHHBHNTBBTHHNHNTNBTHNNBHTHNTNHTNN
TTHNNBNNBNHHNHHTNHNBNNNNHNNNNBNNNHNHTNNBNNBHNTHNTBHBNNNHNNBNNTHHNTNNNNHNTTNBHBNHTNNNNNNNTNBNBNNHHHTN
NTNHNBTBNNHHBHTHTTHTNNNTBHHNHBHHHHHNNBNNNNTNHNBNNTTNTHTNBNNHHHTHHHHNNBNNTNHHTNHTNNTTHNNTNTNBNNBNBNNN
NHNNHNHNNTNTNNNTTNNHTHNBNNHNTTNTTNTNNTTNNTNNNHTNNHNTHNHBNHNBNNTHNHNTBHBNHNNTNNHTHTTNHHHTBNHNNNHNNHTN
BHBNBNNHNBNNNNTNNNHHHTNBNBNHNTTNHTHNBNHNTHTHTTBBHHNNHTNNHNTTNTNTTTHTNNNNHTHNBNHNNTNBTNNNHTTNTNNNBNBH
NNTTNNNNHBHNBBNTHTHNHTHTNNNNNNHTTBTTNTHNHHTTTNNNNHHNHNNBNNHNTTHNBNHNBNNTNNNNTNNHHNNHBTNNHHNNTTNHNHNN
BNHHHHNNNNHHHNNNTNTTNNTHTBNNNNHNTNTNNNHNNHHNNNNNTHHBHHNHTNNNNNBNNNHHNHTTHNTHNNNBHNNTNNHNHNNNTNBNNNNH
BTTNTNNBTTTNBBNTNHNHHNNHHHHNHNTBHBHBNNHNTTBNTTNNNHNNHHHNBHTNNNHTNTTTTNNNNTNHNTNNNTNNNTTBTNHTTTNHTHNN
NTNNBTNHHNHNNNHTHBNTTNTTNTBHHNBTTNTTNTNTNNNNNNHNNNNNHTNNNNTNNTNNNNHTTHBBHNHHNBTTHTTNNHHNNTTTNNHNTNHN
HNHNBTNNHNNHNTNNNHNNTNTHBBNHNNBNNBNNNBNNNNNBNHNNNNHHTHNHHNTTBNBBTNHHNNTHNNNTTNNNNNNNNNHHTNTNHTNTBHBN
NHHTNNNNNTNNNHNHHHBTNNNNNHTTNBBHNBNNBHNHNHNNNTNTTNNHTNNNTTBNNNHTNBBNNNNTNTBTHHNNTNNBHNNHHNTHTNNNNNHN
NTHHNHNNHNBNNNNNNNHHNNTNNTNNNNNNNBNHNTNTHTBTHNBTNNHTNNTHTTNNBTTHBTTBNNHBHTNTBTNTHHTNTNTHTTHNHNBBHTBH
HNBHHBTNTNHBHNBNNNNNNNTNNBNNHNHTHHNNHTTNTTBNNBBNBTNTNNTTNHHTNTNNTNTHNNNNNBBTTNNNNNTHNHTTHTHNTNHTTNTN
NBBBNNHHHNHNHTNNNNNNNNHNBNHNTHNHNTNTTHBTBHHHBNTHNNHNNNTTNBBNTTNHHNNBTBHNNNNNNBHNBNTTNTNNTNNNBHNTNNTH
HNBNHTNNBNTNNNBNNHNTHHHTNHNHNNBTTHTHTNNTHTNHNHNNHNHHNTNHNTHNHNNNTNNHTNHNNTNNNNTNBNBHTHBNHNHTHNHTNNNT
NNNNNHNNBNNNNHNNNHNHBTBHTNNNNHNBTTNNTBNNHNTNNNHNNHNNTHNHNHTHTNNHNNNTBTTNHBNNTBTTNTTNNNTHNHNBBNBNNNNT
NHNBHNNNNHHNTTNTHHTTNNNTBNTBHNNNBNNTNNNBNBTHHNNHNTNNTTBBHNBNTBBNNNNNNTTHHNTNNNNNHNNHHNTNHNBHNTHHNTNT
TTTNNNNTBNHTHHBTNNNHNHTTNNNTNBTNNTNNBBNNNBBNNNHHHBNNBTHNTNNHTBHNTTTTNNHNNBTNHNNNTNNBHTHTNHNNBNNHNHNN
NNTNTNNHBNNNNHNTTHNNNNHNNNHNHBHNNNNNHBHHNTNNNBNNNTTNNNBNNNBNTNHNHNNNNNNNTNBNNNNNTNHHNHHNBNNNNBNNNNTT
NNNBTNHTNNNHNNNHHNNNHBHNNHBNBNHNNHHBTBHBHTTNNNTBTNHTNNNBNHTHTNTBNBTHBBHNTNTNNNNNTNNNTNBHTTHNHNTNNTNN
NNBNHTNTHHTHHNTNNNHTHTNHNNNTNNTTNNNTNNNBNTNNBNTTTBBTNHHNHNNNNNNNTNNHBBNNNNNHHTNTNTNBHHNNHTHHHNHBHNTT
NNNBNNNHHNTBNHNNHNTBNNNTNNNNTTNNNNNNTNHNNTNNHNNHNTNNNNNNNNNHBHNNNNHBNTHHNHHNNNNBNHNNNHTNTNNHTHBNTTHH
NNTNNBNTNHNNNNNNNHNNNHNHNTTNNNNNTTTNTBTHHTNTBNTNHHNNNNTNNHTNHHNNHBBNBNTNNNHNNHTTHTNNNNNNNHNNHNNBNTNN
NNNHNHNNTHHBNNNHNNHBHNNHHTNNHHHNNTNNNBTNHNNNNTBNNNNNBHNBNBBTNTBTNNTTNBBNNNNNNTNNHNHNNTHNBNTHNNNNBNBB
TNTNTNBNNNHNNTNNHNBNHBNNTNNNNTTBNNTTTHTHNNNBHNHHHNTHNNHNNHHHNNHTBNNTHNTBTBNHNTTTNNNTNTNTNNNNTNTTTTNN
NBNNNHNNHNNHHNNTNHHHNTNTNNNHNBHTHTNNHTHBNTNNNTTNBNNBHBTTNBNBNNNNNNTNHNNNHNNBBHTTNNHNNNNTNTTTBNNNTNNN
NBTNTNTBNNTTBNTNTHHNHBNHHNBNNNNBHNNNBNHBNHHTHBNNTNTTNBNNNNNHNHNHNHHTHNTTTHBHNHNHNNNNTBHNNNNTNTTTNTNH
BTHTHNHBTNBNNTBHNNNBNTNNNNNNTBNBNTTTNNNTNNNTNNBNTNNHNTNBHHNHNTNNNNBNNNNNBNTTNNBTHTHBNHNBNNNTHHNTNHHH
THHNNTNBNNTNNHNNHNTBNTBNTHNNTTNNTBBHBTHNHBNNTHNNNNHNTHTNHHHTNTNNBBTNBTNBTHHTNHTNHNNBNNHNNNTNTTHTHNTH
BHNBNNTNNHHNHHTTHNTTHNNNNBHTNNNNTTHNNNNTNHNNNNHTNBHNNHNTHNNNNTNNNNTTTHTTNNTNTHNNBNTTNNNNNBTNBTTNBNBH
NHNTNNNTNHNNTNHNNHNTTHNBNBTNHNNHNHTTHNHNBNHNTNNTNNHHNNNHNBTTTNTNNHHNNNNTNNNBNBNHNNNTHHTNTHHHHNHHHBNN
NNNHBNNNNNTNNTTNNNTNTNNNTBNNNHNNBHNBNNHNTNTBNTNTNTTHHHNNNNHTHTTHTTNTBNNHTTNTBTNTTNTNHNTNTBNTNTNBNNNN
NNBTHNNHTHHBHHBNTNTTTHNNHHTHHNNNBNNNNNTBTNNBNTHHTHTTHBTHNNNBNNTNNNHNTNNNNHNHHBNNHNBNHTNNHNTBHHHBBTNT
BNNNNNNTNNBTNTNHNNNBNNNNTHNNHTNHTTNHNBTNNTNNTNBTBNNHTNHNNNHTBHNBTNNNTNNNBTHNTNTHHTHNTBHNHTTNHTNTTNTT
NTHBHNNBBNNTNBNTNNNBNHTHNTNNNHBNNNNTNBBBNNHHNHNNHTNNTTTHTNNNHNBNHHNNNNTHTHNNTNHNNHBHBTTNHTNNTNTNTHNT
