TBHNBTTHHTHNHNTTBNNTNTHNBNNNNHTNNNTNHNHNHHNNNNBHTNNNHNNNHBTHHNTTNNTTNTNHTNHBBNTTNHTNNTTNHHTBNTNNNBTT
THNBNNNNNNTBNNNNBNHHHHNTNNTNNTNNNNNBNHNHNBNBHTHTNTHTNNNNNNTNHNNBHNNHNNHNBNHHNNTTHHTHHNNBNNTHTBBNNNNH
NTHNNHTHBNNNHTNNTHNNNBHNNTHNHHTTBBNHBNNHBNNNNNTHNTTNHTNNTNTNNHNNHNHTHBBNNNNHHNNNHNHNBNNTBNTNBNNNHNHB
NNHHNNHBBHTHNNBNTBHNNBNNHTNNNHNNHNTBHNNHTNNNTHNNTNNTBHNHTNNNNTNNHHNNTTTNHBBNNNNNNNNHBHTTNNNNNHNNNBNN
NTHNBHNTNNTNHHNTNHNTNNHHTNHTHTHTNNHNNBTTTNNHNNTNNNTHTTNNNNBTNHHTTBBTNNNNBTNBNBNBNHHTNBNTNNTNNNTNNNBH
BHNNNNTNNNTBNNTHHNHHNNNNNNBHHNHBBTNNNNNBHNNNHNNNTNBHNTBTTTHNHNNNHTNHNBNBBTTNHTNBNNNNHTTNNNHNHNNNHHNN
NNHHHTNTNNBNNNNNNHNNNTNNNNNHTBNTNNNTNTNNNNTBHBNHNNNBNNNHNNBNTNHNNNHTNNBNHNBNHHNNNTNNNNNNTNHBNBTHNNHT
HBNNTNHNNBHTTNNBHTNHNTTNHBHNNNHTNNNNBBHTNBHBTNNTHNHTNTNNNNTHTBHNTTBNNTNNNNHNNTNBNHNNNNNNNNNTBHNNNNTH
TTTHTBNNHNNNNBHBNNNHHTNHNTHNHTNHTNTNNHHNHHNHTHNNTNNHTNHHTTNBTHNTHTHNNHNTBTNNNTNNNBBHNTTNNNHNNTNHTNTH
NNNBBHBBTTTNBNNNTNHBNBNNHHNNTNHTTNTTHNHHTNBNHNBNNNNNNHBNTNBHNNTNNHNNTNNNBNNNNTTNHNNHNNNNTNNTNTBNNNNN
TNTBNNNTNNNTHTTNNTNNTTBHNHTNNNNNNTNHHNBNNNNNBNHTTHBHTTNNHHHNTNHTTNNNHNNNNHBNBNTTNNBBHNNTNTBNHBTTNNNB
NTNTNNNHNNNHTNHNBTNTNNNTNNHNNHNNTTHHBNNHHHHNBNHNNNNTBNNNNHNTNNBNNNNNTHNBNNNTTTNNNNBTNNTHNHNNNNHNHNNN
TNTNNNNNNHHNNNTNNBTTHNHNHNTNNNTTNHTBHHBNHNNHBNTTNHBNNNNTNBTNNHBBNTTHNNHHBBBTTTNNNTNTNNTHBNHTNNNNNTTT
NNTNNNBNNHNTBNNNHTNBNTNNNBNNNTNNHNHHTNTNTHBNHBHNNBHHTBNTHHTBNTNNHHNNNBNHHNNNBTNNHHHNHBNTBTNTNBNTHTNH
TNBHHNNTHNHHNBNHNTTBNNBTTTNHTNTNNTBNNNHNTNNNNTHTHTNNHNNNTNNBHNHNHNNHTTHHHTBNNNNNNNTNNNBNNNHNNTTNHHNH
NNNHNHTNHNNTNHNHTBNNNNNTNNHTHTHHTNNHBBNTBNNNNNNNHHTTNNNNTTBNNNHNNHTBNTNNNTNTNBNNTNNNNHTNTHNNNNTHHNHN
NNTBNNNNBNHTNNNTNTNNNTTBNHNNTNNHHTHTNNNNNNHHNBHHNNNHHNHBNHTNNNBNBTNHNTNNBHNTTHNNHNHTBNTTBNBNBNHNTNTN
NHNHNNNBHNNTNNTNNNNNNBHNNNHNNNNTNTBNTNTNTHTNBNNNNHNNTNNNNTNHTHTNBNNHNNNTHNNTNNTTNHNNNTHNNNTTBNBNBBTH
HHNTTTNTNNNBNNNNHNTHNNNBNTTNNTHTTNBTTNHBNNBHNTTNTHNNNNNNTNNTNNNTTTNTHBNBNNHNNNTNHHHHBHNHNTTBNTNBNHNT
NNTNNNNHNBNNTNNNNHNNTTBNNNNBNBBNHNNNNHNNTBTNNNNNNNNNTNBNTTNHNTHTTBNHHNTHTNNNBBNTNNNHHHHTNHTNBNNTTNNT
NNTNTNNHTNNNNHNNHHBNNNBNNTTNNHNNHTNTNNNHHTBNTTHNNNNNNNNTTHBNNTTNTHNTTNHNTTTBBNTNTTNHBNNNNHNNNNNNNBNN
NTNNNNNNTBBHTNNHNNTTHNNTNTTTTHBTNNTBHTNTTNTNBNNHHNTHTNNHTBHHNNNNHTNNTTNHTNHHNNNTNHNTHNTNNNNHNTNNTHBT
NNNHBHHNTNNHBNTNTNTNNTTBTTNBHNNBHNNTTHNHHNTNNHNHTTHNNTTNHHNBTNNTHTTNNNHHNNHBHNNNNHNTTNHTHNTNNNHBNNTN
TBTNTTNTTBNNNNNNNHBHNNNNNNBTNBHTNHTNTBNBTBHTNNHHNNNTNNTHTHNNBTBTNBNNTNNHNTNNBNBNNBNNBTNHNHBBHBHNHHNT
NNTNBNNHNBNBTHNBNNHNHHHNNBNNNBHTNNHTTNBNNNHTNTNTBNHNNNNNHBBTTHNNNHNHHNTTNBNBNNNTNNBNNHNNHNNNNNNBHNTH
NNBNNBNNTHNHTBHNNNNBHNBBNHBNTNNNNNTTBNTNTTTNHNHTNTBHNHBHNBTNNTNNNNNNNBHBNBNBTTNNHNTBNTNNHHHNHTTTTNNN
NNNNTNHHNTBNTTTTHHHHNHTHTHNNHNTHNNNTNNNHNNTTBBTHNBNNNBNNTTBNHHHNNNTBNHTNNNTNNNBNTBHTHNNHTBNNNBTNHNHT
NBNTNHTNHNNNNHNTNBNTBNTNHBHNNNNHNHNTNNBHNNNNNTNHTBNNTNNHHHNHNNHBTNNNHNHNHNNNHNNHNHBHNNTTTNNNHTNHNNBN
HNNNNNNNHHHNNTTHNHNNNTHTNNBHNBHTNNBHTTHNHNNNTHNTBHNNNNBTNNNTNNNBTNNBNNTNTNTNTTHHNTTNTNTNNNBTNNTTNNTN
NHNTNNNHNNNNNNBNNNNNNNNNNTBNNBHHHNNTHTTNTNTNHBBHNTBNNNNBNHNTNHBBTNBNBHNBNBBNBTHTNHBNNBHTTHHNNBNNTTHN
HHBNNNBTBNNHTNNHHNNNNTNTBTNHHNNNNNNNNNTHNTTNNNNNHNNTBHNHHNNHTNNNNTHNTNBNBTNNNTHTNNHNNNNHTNTNNBHHNNNN
HTHNHNNNNNHNNHNNNHHNBNTNHHTHHNTNTNHNNNBNNNTBHHHHBNTHHNNBHNNTTTNTNNTNHNHNNNNNTHTNHNTNBNNNNBTNHNNTNNHN
NBNNNTTNBNBNTNNTNTNNTNBTNHNNNNNNNTNNNNNTTTHNHNHTTTTNBTTNNHHTTBBNBNHNTNNHNNHHTHNHTNNNTNBNTNHTHNNNHHHH
NTTTNHNTBBTHTNNNNTNNTHHTTNTBTNNNBHBTNHTHHBBNNNNNTHNNTNTTNHNNTTNBHNNNNHHNTNNHNNTNTHTTTNHNHHHNNNBTNHHT
BTHHTNHTNNHTTNHNNTNHTNBNNHHHTHBNHNTNNBNTNNNHHBHNNNNHHBNHNNNBHHNHNTBHNNTBNNBNHHNBTNNNNNNNTNHNNHBBNNTH
NNHBNNBNBNNNHHBNNNNHNNBNNHTNNNHBNTNNNTBNNNNNTNNNHNHBHHHNNHBBTNNTBHNTHBNNTNHHNNTHTNBNBNNTNHNNBNHHNNNH
NNHTTNNTTHNTNNHNHHNTNNTBHNTNBNNNTNHNNHTNNBNNNTNBBHHNNNBHNNNTTNNNBHHNHNBNHTNNNHTNNTNNHNNHNHNTNHNHTNHT
HNNHBHHHTHHNHHNNHNHHTBNNHHHNNNNBNNTNNNNNBNNNHNNNNNTTNNHNNHNTNNNTHNNNNHHNTNHNNNHNBNNHNTNNTTTNHNNBHNHT
HBNHNTNBNNNTTHNHNHTTNHHNNNTNHTNHNNBNNNHHNBHTNHHNNHNNNTNNBNNBNNTNNTNBNNTNNNTNHNHHNTTNHNNNHNNNNHTNNNNN
NNNHNBTBNHHNNHNNNNBNNNTHNBHHTNNTHHNTNBNNHBTNNNNNNNNHTHNNTTNNTNNNNTNHNHNNNBTNTHHTNNNHNNHNNNHTNTNNTTTN
NNTTHNNNNTTNNNHNHTNNNNNTNBNNHNNTTNTHNNTHNBBNNHHNTNTHNHHBHNTTTNBTHTNNBNNHHTTNNNBHNHNNNNHHNNTHHHNNHHNN
HNHTNNBNNNNBNTNBNHHNNTNHHNHTHNNBBTBHNNNNTTNTHNNBHTTBHHNHTNNNHNTNNTNHNNNBNNNNNNNTNHTNBHBNNNTNNNNTNTNN
NHNNTNNNHNNTNTNBTNNNNTNHTNNNNHTNNHHTTHHHTTNHNNTHNNNNNTNTNTNHTTHTNTNNNTBHNHNBTNNHNNBNNTNHBTNBNBNNHHTN
NTNNBNNNBHNNHTNNBNNHNNHTNNNNTTBNTBTTNNNBNNNNHNNTNHHTTTTTHHNTHTNNNTBNHTTNNHNTTHNHBHTNHTBNTNBNHHHNHHHH
BNNHNTNHNNBNNNNBHHTNTHHBNNTNHNTNBHBTTHNBTTNTNHNHBNNNNNBNNNNBNHNNBTNNNNNTHNNNNNHNBNTNNNNTBNTTNTTNTTNH
TBHHNTNHHNTNNNTHHTNTTHTHNNNBTHNTBBNNNHTNTNTNNHHHNNNHTNNHTTNBTBTHBTHTNNHNHHHBNNBHHNNNNNNTNBTNHNHNTBHT
BNNNNNTBHHTNNTNHTBTNNTHHHNTBNTBHTNTNBHNNNNHNNTHBBNNNHNNNBNNNTNNHBBNHTTNHHNHNHNNNHHTNTNBNBNNNNNNNTNNN
NNHNHBNNNBNNTNHBNHTBBHNHHTHNNNBNTTTTNNNHTNHNTTNHHNHNNNNNNNNHTHTTNNNBNHTHBTHNNNHBNBHNHHHNBTHTNNNHNTHB
NBNHNTHTHHNNNNNNNBTTNBBNHNTTHTNTNBNNTHHNTNHNNNTNHNTNHHBNNTHHNTHNHNTNBNNNNNNNTNHNBNNNTNHHNNHBTTTHNNTN
NNNNTTBHNHNTNBNNBHNHNNNNTNNNTBTTHNHNTBTNNHNNBHNNBTNNTNHNTNNBNHTNNNHNNTNNTHNNHTTHTTBNHNNNTHBNNBTBTBTN
NNNHNNNTHNNBHTHTNHNTNNNNNNBNHTNTTTNTBBNNBNNHNBNHHTTHBBBNNTNNBNNBNTNNNNBNNNNHNNNBNNHNNHNBBNTNNNBNHNHN
NTBNTNNHNNHBNHNNNHHTHTBHBNNNTNNHNHNNTNNTHNHTHNNBNNHNTNHTNNHHNNNHHBNHNNHTTNHHBNTNTHBBHTNBNHTTNNHNHNHN
BNHNNTNNNNHNNHNNHNTNTBNNTNNNNHTNHNNTNNTHTBBNTTNHNNBNNNNNNNNHTTBNNNTNTTHHNNNNHNHHTTHTNHBBNHNNTTNNNTTN
TNTTHNNNNBNHTTHNNNHTBHTTBNNTHNNBNNHTBNNTHHTTBBNNNTHBTHTNHNBNHHNHNNBNNBNHHBTTBNHNNHNHTNNNNHNHNTTHHTNT
BNNHNTHNTNNTHNNBNNHNBHNHNHNNNNBNNNTTTNHNNHBHNNNBNTNNBHBNTNHBNNTHTNHNNNHTHNNHNNNHNTNNNNNTNNTNNNNTTTNT
NNNNHNBNTNNNNNHNHBNNNNHHNNNHNBNNNHBNNNNNTNNNNNHNNBNNHNHTHNNHNBBHTHHTNTNHNHHNTTNTNTNHTHNNHNTNNBNBNTNH
HHTTBNBNNTHNNHHNBHNHNTNNTNHTNNNBTNNNBHBTNNNBNNNNTHHNNNTNTHHHTNTHBBNTNNNNHNHHHNNNBNTBHNNNNHTBTNNNNHBN
HNNHNTNNBTTNTTHNNNTNNHNBNNNTHNTNBBHBNHNNBHTHTNBNHNHTHNHHNBTNNTHBTNHTNTNTNNBTNBBNHNHTHNNTNBNTTHNNTBBN
NBTNNNNNNHNTHTNNTNHHBTNBNTTHBBNHNBNNNHHNTNHHNHTNNNTNTNNNNHTTNTNNNNNNNNNNNNTNTHBHTTHHNNHTTNNNNTTNTNNN
HHBNBNHTHTNBNHNTNHNNTBTHHNHNTNTNNTNBHNNNNNNNNTNNNHHNHTHNHNNTNNNTBTNBNHHHNHTNNNNTNNNTBBNNBNBBNTBTTBNN
NNNNNNHNBTTNTTNHBNNHHTNHNNTNNNNNNTTHBHNTNHNNHHTBNNHNTNBBTBNNNBTNHNNNNNTNBNBTHNNHTTHBTNNNTNHNNNNHNNNN
NHHBNNNNNTNNTHTNNTHNNNHBNTHBHNHNNNTTNTTTNNNNNNNNNNNBNHBBNBNBBNNHHTNNTNTBHHHHBNNBNNNBTTTBTNNHTTNNTHNH
NTNNTTNNTNHNTHTBTNHNNBBBNHNHNNHNTTTTHBNTHBNNNNBTNNBNTNNNNTNNBNBNTBHNNHNTBNHNNNNHTHHNNTNTHHNNNTTTHHNN
NBNBNTTHNNTNTTNHNTNNNNNNNNNBNBHTBNNNTNNNTBNNBNNTTNTHBBNHNNNHTHNBNHHHTHNTTTTNHNBNNBBHNHNHHHBNNBNTHNNH
TNHBBNHHNNHNNNNTTHNNNTTHHTTHTTNNHNTNTNNNNBNBNBNNHNNNBNBNNHNTNTNNTNHBTNTTNHBNNTNNNNNNHNHNNNBNNHTHNTNB
BNTBHBNHNNNNNHTHHNHNNHNHTNNNNNHNNNHNNHTNHTNNNHBTTTNHNHTHNNTHNNNHNTNNNTHHBNNHNNNHBNTNTBNNTNNNBNTTHTTN
NHHNNHBNNTNNNNTNTNNBNNHHNTNTNBTHNBNHNNNNNNNNHNNNNNBHNNHBHNBTTNBNNNNNHNTHNNNHNHNNNNTBTHTNHNNHHHNNHNTN
NBNTNNNNNBNHNNNNTNNHTNTNNNNBNNNTNBBNNHNHNBNNBNTBNNNNHBBTNTHHHNNNNTTNNHHNBBTTHNNNNNHNBTHNNHNHTBBHNTNN
HNNNHHNHTHNHTHNHHHNTHHTHNTNBNBNBHHHNHNBNNNHHNNTHNNBNTNHHBBHNNBNHNTNBNNHNTNNNHHTTTNNNHNNNNBHHTTNNHNNN
THNNNTBBHHBNNHBNHTBNTHTTNTNBNBNTNHNBNHHHNHHTTHNTHTNTTBTNHNHNNTNHTNNNBHNNTNBTHHTNHTBNNBTHNTHNTTNBNTTN
NNNTNTNHTTTHNNTHNNTBNTNNTBNNNTTNNHHNNNNNBHHHNTNHNNNBNNHHNTNNNHNNHHNNNTNTHTHTTTNBNBTNNNNNHTTNHTHNNHNB
NNTNNNNTHNTNHNNBTNNHTNTNHTNNNNNTHHNNTBHNNTNTNNTNTHTTHNHHNNNNNTNNTNTNNNNNNNNNHNNBNNTTNNNNNTNNNNHNHNHH
NTNBNNNTNTHBNNTTHNNTBNNNNHNHTBNHTHTNHNNHNBNNHTBNTNHNTNNBNNNHNNNHNHHBHHNTNHTNNNNHBNNNTNTNTHHNNBBHTNNH
HTNNNNHTHNTNNHTHBTHHNBNNBNHTHNNHTTNNHNTNTTNNNBBNNNNHNHNNNNHNTNNTNTNNNNNNTBHNNNTNNTNNTTHNNTBHNBNNNNNT
NNNNNTHHBTNBNNHHTTNHNHNNHNHNHNBNHNHTNHHBBNNNHNNNHTHHNTBHNTTHNTNTBHNTTTNHHNTNHNHTNHNTNTHNNNNNBNNHNBBN
BNBHTTNHNNBTBBNBNTTHNTHTHHTNBTNNNTHNNNHNNNNBNNHHBNNBHNNBHNNNNNNBTHNHNHNNNNNNTNTBBNHTNNNNTNNHNNNHTTTH
TNHNBTNHNNNTNTNNHTHNNTNHNHTBBTNBHNHTTBNNBNNHTTNTBTNTBHHNHTNNTNNNTTNNBTBTNTTNHBHTNNHHHTNNNHTTTNNNBHNH
NNNHTTNHHHNNBNTTNNHNTTBNTBNNNHNBNNNNNNHHTHNHTTNNNHNBHNNHTBNHTHNBNBTHBHHTTNNNHTTNBTNHNTHNTHTBNTTNNNNN
NNHBNNNNHNNNNHTTNNBTNHNNNNHNHTNNTNTNTTNNNNNNNHNTBTBNNTNNNTNTBNNTTTTNNHNNTTHBNHBTNNNHNNNNBBNHNBNBNBNT
NBBHHNBNNHHHNBBNNNTNTHBNNHHTNNNNTBHNNNNNNHNNTTHTTTNHNNNNHBNNNBNHTNNBNNTHHHHHNTNNBTTNHTTTTNTNNTNNHNBH
NNNNTNTNNNTNHHBNBHHHBHHTBHNTNNNNNHHNNTTHNNNHTNTBNHNHTBNNNNNHBTTNTNNNHTNNTNBNNHHBNTBNHTNNNTNNHHNTHTHN
HNHHNBNHHNTTNNHNTNNTHHBHNNTBNNNNNTHNTTTNHNNHHNHNNHBHBTNHNNTHHNNNTNTNNTTHTNNNNNHNNNBTBTHBTNNTHNNNNHNT
NHNHHHNNTHHNNNNNTBNTNNHHNNNNHBHNNNNTBNHNHHNNNNTTNTNNNNHNHTTTNNNHNBNTHNNNNNBNNNNNBTHBNTTNNTNBNBTNNHNN
HNHNBHNNNHBNNNNHTTNBNNNNHNHNHNHNNNTBHNTNBTBHNBNNHNNNNNNBNNTNHNBNTNNNNTBTTNNNBTHTHNTNNNNNBHNHTNNNTTNN
NNBHTNNHHTNNNNNNBTHNHHNNBNHBTNNBTNBNBHNNHBTNHNBHTNTTNNNBNHNNTTNNNNNHHTTTTHHBTNBNNHBBNNNHTTHHNNNNNTTB
TBNNBNNBHNNNNHHNNNTBBHHNHNNHBTTNTTTHBHHNNNNTNNNNNNHBTTHNTBNTBBBNTBBNHNNNTHNHTNNTBNNNNHNNTHNHNNNNNNNH
NNHNHBHNNNTHNHNNTTHNHNTTHNNHNNTNNNTTNHNBHBNTNNTNHNTNNTNNNTNTBNNNHNNTNNTTNBNTTNBTBTNNHNTNNNHTNNNBBHNN
NTBNNHNHNNTNNHTNNHNBNTTNNNTNTNNTNNHHTHHHNTHNNNTTTHNNNBHNTNNNNBHTNNHHNNNTNNBBNHNNNNNNHBNTNHNNNTNNTHNT
TTNNNBHBTNNHNHBNTTNNNHBHNTTHNHNBTNNNTTBNHHNNHNNTNNHTBTNTBNHBHNBHNHHHNBNTNTTHBTHNTNBHNHNHHNTTTNNNNNHT
NTTNTTTBNBNTBTNNHTTTNTHNNNNNNBHNNTNNTTNNHNNHNNHHHBHTNNTTNHBTHNNNNTNTHTNTTNNNNHNNTTBNTTNNNNNTNNBNTNNN
NNNHNNNNBNHNHTNNHHNTBNTNBNNTTTNNHTHNTNHNNNNBHHNHNTNNNHHHNNHNNNNNNNBNBNNNTNNTHNNBNNNNNNTNTNNNNNNHBTHB
NTBNNNHNTHHNHNTTTTNHTNNNNHNNNTNNTTNHTHNBHTTNNNNTNNHNNHNTHBHNTBNTNHHNNNHHHNNHNHHHBNNNNNNTHNTNNHTTHNNN
NBTHNNNNTHNNNNTNTBHNTNBTNNNNTNTBBNNBBBNHTNTBBNNBTTTNNHHNTNNNTNNTHHTNTHTNNTTBNHBNTBNNNTTNNBHNNBHHHNNB
NTHNHTHNTHNBNNTNTTHNNNHTNHNTNNNTNNHHNNNTNNTTHNTHNHBNNNTNTNTNTNTTHNNNHHNNNHNNBNHHBHHNNNHNHNNTBHNNNNNT
NNBNNNTHBNTTNBTNHTTNHNNTHNNTNTTBTNNTBHNHTNNHTTNNTNNTNNNHBHNNBTHHTNHHNTNNNNNNTNHNHHNNNNHNBNTNTNBNTNNT
NNTNNNNHNNBNHTTNNTNHNHTNHNNBNHNTNTNNHTBNHHNNHTHHNNHHBNNTNNHNBHNTHBTNHNTBBBHTNNNNTNTTHHNNBNNHHBNTTNTN
NNTHHBHHNTHNNTNNHNHTHHHNTHNBHNBBTBHNTHNNNHNHNNNHTNNNNNNNNTNBTNTNTHHNBNHNHTNHNNNHHNTNHNNHNHNHNNBNBTNN
NNHTHNNNTTNHNBNNTNTHBBTHTNBTHTTNBNHBNHNNNHNNHNTTHHNBBTNNNNNBTTBTNNNNNNNTTNNNTNNNTTTNNNNNNHBHHNTNNNNN
NHTNNNHTTNTHHBNNNTNTNNBTTNTTTTNNNNNHNNTNNNNNHNHNBNNNNHTNTBNNNNTNBHNNBHNHBNTNNNNHNTHTHTNTNHHTNNNTNHNN
TTBNNTNNBBNBTNNNNHBNNNBNNNHNTHTHNNHTHHNNHNNHTBTTNNHHNNNNNTHNNNTTNTTNNNHTHNNNNTNBNNHTHNNNNBTNHNHNHTNH
