BTBNNHNNNNNNTNNTHHHNTNNNTBTHTTNHHNNNNHTBTTNTNNHNNTTNBHNNHTNNBBNNNNBTTNTTNBHNTTNNHNNTHBHNNNNHNNNBNNNN
NTNNBTBHNNNHHNNNNBBNNTTNNNNTNTTHNNNTNNHHBBNNNTBNNNNNBBHNNNHHTNNNNNHHBNTNHTTNBNNNNNNNNNHNNNHTHNNNNNBN
NNHHTNNNHHBNNNTNNTBHNNNNTHNBHNTNTTBTHNNNNNTNHHBTNTNTBNNNHNTBNBNNHTNNHTNBHNNTNNNBTNNNNNBHNHNNNTNHTNNN
NNTTNHNTHTNNNTNNTBNHBTNBTNBBBBNHHNHNTTNNNNNBNNNNNNBNNNNHTNNNNHNNNTNNNHHNNNNNNTHNNNNTTNTNHNTNHNNHNHBN
NNHNBTHNTNTNTHBNBNHHTNTHNNTTNHHTBNTTNNNBNHNBTNNNHNNNNHNNBNTBNNNHHBTBBTTNHBHNNTHTNNNBHNTNNNHBNTBNTNTT
TNTBBNHHTNNBNTTNNNHTTNNNNNHBNHNTTHTNNNTNBNNNNHTTHNNNNNNNHNNNHHTNNNNNTTBTNHHNBNNNNBBBTNNTNHBHNTNHNNHB
NNHTNNNNNNTBBHNBNNNBNNBNNBNHHNBNHBNHTTBHHHNNNNTTTHTNHBTTHNNNHHTHBNTNNHNNBTNNBHNHTTNNNNNHNTNBNNNNNNNN
TTTHBBNHNTNNHTBTNNHHBTNTNNHBTNBBNTNBBTNHNHNNHNNTNNHTNBNHTTHBTNNBNNTTTNTBNNNHHNBNHNTNBNTHTNBTTNNBTNNB
TNTHNNTNHTNNNTNNNBNNNNNNNNNNBBTNNTBTNNTNNTNNNHBHHTNNNHHBHNNTHTHHNNNNTBBHTBHNNTHHBBNNTNHNNHNTHNNBHNTN
NNBNBHTNNNNNTHBHNHBTNNTTHHNNHNNTHNNNTBNNTTNNNNNNTHNHNHBHHHNNNNNNHTHNNNNHHTTNHNHHNNTHTTTNTTNHNNNHBTHH
NNNNNHBNNTNBHNNNNHTNTNTTNNTHTNNNTTNNBHNTBBHHTBHTHTHTBTHNTNHNTNHBNNNNNNBNBTHBTNNNNBTNNNTNTNNNBTNNNTNH
NHTTTNNHHBHNNNHHNNBNNNTBNTNNNHNNNNNTHBNHHBNNNNNNBBBTHHNNNHNNNNNNNNHNBNNNTTHNNNNBHNNHNNNNHHBTTTNTTTNN
NHBNNNTHBNNTNNNTNHBHNNHNHNBNTNTNTHHTTHHNNBBNNBHNNNHTHBTNNTNBHTNNHHTNTNBNTNHNNBBTTHNNHNBHNBNNBNBTNHNN
THBNTHTNHNNTNNBNHHBNNTNNHNHBNNTHNBNNBNBNNHNTNHNHNHTBHNNHBHHNHHTNBNNHNHTHHNBNNNNTTTHNBTNNNNHNBHNNHTNT
BTTHNBHHNHTHTTNNNHHNNBNBBNHNTNNNBBTNTHTNNNTBNNNNNBTNHTBNHNNNBTNNHBNBNNTNBHNHNHNNTTNTNTBHBNNNNNBNNBNT
NNNNNTNTNTHHBHBNNTNNTNHNBNNNNHNNNHBBBNHNBNNNTHNNTHHNNNTTTNTNHNNTNNNHTNNTHNBBNNHTNNNNNTTNBNTBTNNNNHNH
HNNNNTTHHNNNNNTHNNNNNHHNTHTTNHTBTBNNBHTBHBBNNHBTNNTNNTTTBNHBBNNTTTNNNTNBNNTNHTHNNNTHNNNNNHHHNNNNHNTH
NBNNHTNTTBBNNTHBNBNTBNNNTNHNNTNTTHHTNHHTNHTHNNNTNNNNBNNNNNHNBNHTNNHNNNNTNTNNNHNNNTNNNNNHHBNNHNHNNTNN
BNTHHBTTHHNNTNNNNNHHTHHNHTTNNTBHNHHNNHBHHNNBNTTNBBNHNNNNTBNTNNNBNHNNNNNHTNNTNNNHBHNNNBNTNTTNHNNNTNHH
TTNBNNNNTNNNNNTTHNHNNNBNHHTNNNNTTNNNHTNBBNHNNNNTNBTBNNTHHNNTHBBNNNNBBNTNTHHNTNHNHNTNNHTBHHTNNNTTHHNN
TNBTHHNNBTNNTTBTHNNHNNTNNNNNTNNNBHNNHTTNNNNNBNNNHNNBNHTBHBNTNNNHTNHNBNHNNNTHNNNNNBHTNHHBTHNNBBHTTNTN
TNNTNBNNHTNNHNNBHNTTNNHNHNNTHNNNNHNHBHTNTNNTTNNTTNNHHNNNHTHNTTNNHBNNHNHNNBNHHNNTTHTNHHBHBNTBHNBHNNHN
HBNNHHNNHNTBNTTNTHNTTHHBNTNNBHNNNTTNNNNNNNNTTHBHHNNNNNBNNNNBNHHNTTNHNNNHNNHBNNTTNBNHNNNBTTHTNNNNTNNN
HBHNHNNTHNNTHHHHNHHTTNNNNTNNTTNNNNTNNHBNBHHNNNHNNBNNTNHHNNNTNNTNTNTHHNNNNNNNNNHTNNNNNBTNHNHNTTHHTNNN
HTNNTTBHNBHNNHTNBTNNHTNHTNHNHHNHNNHNBTBHNHNNNHNNHNTHTNBNNTHNTTNTHNHHHTNNBHNBNNNBNBNTNTNNTHBBNHNHNNTT
NNHNNHNBNHNNNTNNNHNTNTNNTNHHNNNTNBNHTNHTHTNBTHNHNNTNBBNHHNBHBBNNNNNHNTNNNNNNHBHHNNTHHNNHNNTNNNNNHHBH
HHNBHHHHTHNNTTNNHNNHHTTTHNNTNNTNNNNHTNNNNBBBNTNNTTNNBNNNTNTHTNNNNNHNTBTNNNBBHTNBNNBHNNTHHNNTNNHTNNTN
BNTNHTBNBHTNNNNTNTTNTBNNHNTNNNTNNBNTHTNTTNNHNHNHNNNHBTHHBTNNTNNNNTBNNTNNHBHNBNNNTNNNNNNHNHHTTNBNHHNN
NNHNHNHTNHNTNTNTHTHTBNNTBHNTBTTTNNTHNNNHHNNTNNHNBHTNTTNNTNNNTHNNBTBNNNNNBNTBNTHNNNNNNHTNHTNBNHBNNNTB
NNNTNNBNBHHHHNNTNNHTTNNHNNBHNHTNTBBNHNNTNNHNNNNNNTBBTNBHNBBNHNTNTNNTHHHNNBNNBNBNNNNHNNBHHBNHBNHNTNTN
NBHBNTTNNNNTNHTTNTTHHHTNNHHBNNNNNNTHHNNTNHBTTBNTNTTTHHTBHNHNTHTNNNNHNTNNHNHNNTBNNBNHHTBHNNBHNHTTNHHT
TNBNNNTNHNNNNTTNNNNNHBTHTHHNTNNBTNBNNBHNHNNNNNNNHNNNTNNTHTHTHNTNHNNNHNNNNHNTNHHTNNHNHNNHNTNNTNNNNTNH
NBTNTHTNHBNNHBHBHHHHNNNHNHHTHTBBNTNBTTTNHNBNNNNNTNNHTBHBHHNNNNNTHBBNNNBHNHNBBTNNHHTNNHNTNBTNNTTNNHTH
NHHBHHTNTBNBNNHNTNNNNNBNNNNNHTNNHNNTHHNTNNTHNNNNNNBHNHNNNNNHNNHNNNBHNHTTNTHTNHBNNHTNTNNTNNNBNNTHNNTB
THNTBNNNHHNNNTHBNNTNNHNHHNBTHTNHTNNNNNTHNTNBBTNNHTNNNNTNTNHNHNHHHNNNNNNHTNNBTNNNTNNHHNHNTHNNNTHHNNNN
NHNTHHTNNTBTNTNBNNTBNNHNNHNNHTNHHBNNTNNTBNTNTBTBNNHNNNNNTNTNTBNNBNNNNNHBTBNNNNNBTNBHNTNTHNNHNTTTNNTN
NNTNNBNTHNTBNHNNBNHTHNNNTNBTBNTTHNNNHNTBBTNNTHTNHTNHTHTHHBBHHNHHBTTNNNHNTHHBNBTNNTNTNTNNNHTNBTHTNBTT
NTTTHNBNNHHNNNNNBHNBHNHTHNNHNTTNHHNNBBHBHNNNBTNHTNNNTNBHHNNNTHNTTNNNBNHNNBTNTBBNNTNNNHHNNTNBHNNTHHBH
NBTHNNHNBNTTHNBNNNHBHHHNTNHNNNTBNNHHNHBNHNHTTNHTTNHBNHNHNNNHNNBNBTHNHTNHNNTTNNBTTHHNNTHNTTNNNNTNHNNN
HNNNNNTHTTNHNTNNTNBHNNTHNNBNHNHTBHTHNNBNNBTHNNNHNNTBHNNBHNNNNBNNBNNTTTTHNTNBBNNNTNHTNNNNTNTHTHNTNNNB
HTNTNHBNNNNNNNHNNNTNNTNTHNTTNHNNNNNTNBBNHBNBHHTNTNBHTTTHNNHNNNNNHHHNTNNNTNTNTTHHNTNBNBHTHNNNNNHHHNBB
TNHNNNTNTNNHNTNHNNNNNHHTNTNTHBTHTHTHNNNHTNNBNNHNNNNTHHNNNTNHTBHNTNNTTTBNHNNNNHTNNNNHNTBTTNNTTHNNNNHN
NNBBNNHTHTNBNNBHNNNNHHNBBNNNNNTHNNTHNNNNNHNTHNNTNNNNHTTNNTHNNNNBBNBNTNNHBNNTHNNBNHNTNNNBTBTTHNHBHTTH
NNNNNNNNNHNNNHNHNNNBHHNHNHNNTNHNNNBTTTNTBNTBNHNBNTTNTNNNTNTNNTNBBBNNHBNNBNBHNBTNNNNNNNNTTNNHTNNBTTNT
THTTNNBNBTHNNBNBHHHHNTHNHTHNHNNNNNNNNNTTNNNNBNNTHNNNNBNNTTHNNTTHNTTBTNTHNHHNTNNNHTNNNHNHNTNHNNNHHHNH
BHNHHNNTNTNHNNHTHNHHBNNBNNNBNNNNNTTNNHTTNNHHNNNHTNNNHBHTTNNNHNHHNNNNNNHHHNNNNTBNNHHTBHNHNNHTHTTHHNBH
NNNHTNBNTHTTHNNNHNTHBNTNHNNNHTHNNHNTHBTTNNTTHHHHBTNTNBNNHTNNBNNNTNNHTTNNHNNNHTHNNNNHTBTNNTTNNTNNNHTN
TTHNTHBNHNNNNHHHTNBNHNNNNHNNBNNNNNNNTNHTTNBTNTNNNTTHNNTHNHTTNNNTNHTBHHHBHTHNHBHNNHTNHNHNNHTHHNNHHHNN
NNTNTTBHNNHNHBTTNBNTHNNHNTHNNTHNNHNNNNNNTNNNNHNNTNTHTNNBNHNTBNHBNTHNTHNNNBNNHHNHBHNHTNNTNNHNBNNHNHNH
HTHNTNNNNTTNNHNHBNNNNBBNNBNNTNNHHTHNBHNNHNHNHNHHHNNNBNNNNTNHNNTNTNNNNTNTNNNTNNNNNNNNHTTHBHTNNTNNNHNN
HTBNBTNHNNBTNNNNNNNHTHTHTHHNNNBNHNNNNNNNNNNTNHNNHTBBHTNTNTNTTNNNNNNNBHNNTBHBNNBNTBTNTNNHBHNNHTBTNHBB
THNTTNHNNNHTNNNNHNNTNBNNNTTNTHBNTNNNNNNTBBBTTNNTBHHTHNBTNTHNBNHNNHHTNNNHNNTNNNTNNNNNNNTNBNHNTNTNHTBT
NHHNNTTNHTNHNTTHNHNNBTNNNTBNTNTNBNTHTTTTHHNHTTTHNHTBHTNTNNTTTHNNNHNHNBTNNTNHNNNNHNHNNNHHNHNNTBTNTNNN
TTNBTNHNNNNTNNNNHHNNHHNNTNHHHNNNNTNNNNNNTHNNNTHNNTNTHNHHTNNNHNNNTHNNNNNNBNNNHHNTHNNTHTNNNNBHBNHNHNBN
HHNHNTHNNHHNTNTHNHBBHTNNHHNNNNNHNNNNTNNNHNNNTNNTHTHNTBHNNNTHNNHNNTHNHNHHTNNNNTNTNTNNNNNTHNTNNNNNHNNN
NHNHHBNTBNNNHTNNHNHNBNNBBNNTNNNHTBBHNHNNTNNBHHNNHTNTBHNBHBTHNHHTBNHHNTNNNNHNTNNNNTNNNHTTNHHHTNHNBNHH
HNNNTHHBNNBNNNTNHTNHTNHTTNTNTNTNTNHTNNTHTTNNTNNNNTNNHNHNNTTTNNNNTHTHNTNTNBNTNHNHTHTBNHNNNTHNBNTBHNNH
NBHNHNHHNNHNNNNNHTHTHTTNHNNNHNTHNNNNNNTNNHNTNNHNNTNNNNHNHNNHNHTNBHTBTTNNTBNTNNNNBNNNHHHHNNNBHBHHNTTN
BNTNNHNNHTBBNNNNNTBHHBNHTNHNTNNHNTNHHHNBNBNNNBBNHTHBBBBNBNTNTTHHTNNTBNNNHNTTNNNHTTTBNHNNNHTNNNNNHNNH
TNHHBNNTTHNNTHNNHTHNBHNNHNTNHNHHBNNNNHNNBNNNBNNTNNTNTTHNHNNTNTNNTTNTNNHNNNNNNBBTNBNBHTNNNNNNNTNNHHTT
NTTNNHHTNTNNHHTNNNHNNNNNHHHNNHNNTNNNHNTBNNTBHNHNTNHTTTBNTNHHNTBNTNTNTNNNNNNBHNNNBNNNBNTNHNTBTNNNNTNH
NHNHNNHBNNHTNNNNNNNTBTBTHBNNTHHNBNHHHBTNHHTTHBNTNNTHHBHTBBNNNNNNNNNNNTHTNNNTBHHTNNBTTNNTNNNNBNBTNTBH
THHNNNNNHNNNTNHNHHBTNNHNNNTNNTHNNNNTHHNHNNNNTNNTBNHNTTNHTTNNBBNNHNTNBNHNBNBTHHTNTNTBHNBBNNBTNNNTNTNN
NHTNNNTBNNBHTHTNNTTBNNNNTNNNNTNTHNTTTNNBNNNTTTNBHNNNHNNNTNNNNNNHTNHNNNNNTTNNNNTTHNTNTNNNNNNNHTTTHNTN
NHNTNNNNNNHHBTNNTNBHBHNNHNBNHNHNHNNNNTNTNNNNTBTNHTNBHNHNHNNNHNTBBNTNHNNNTTNNNTHHHNHNTHNNNTTNNTHTBNTN
TTNNBHHBNTTHTNNNNNBTNNBBTHNTTBNNTNNHNNTNNNHTNHNTTBTHNNTNBHTNNTTNBNNNNHNNNHHNNNTHNNTHTNTNHTNTNNHNNHNT
NNNNBNHNTNHTNTNNBHTTBNBTNNTNNNNNNHBHHTHNBHHTNNTBTBNNHNTNHTTHBBNBTNHHNNTHNNTHNTTNHHHNTTHHNTNTNNNNNHNT
NHBBNTHNHHNHHTNTHNTTHBHHHHNBHTHNBBHTNNNTHNNNHBHBHTNHNHNNHNBTHHNBHNNBTBNNNNNNHHHNNNNNNNNNNTNTTTTNNHBN
NNNNHNNNNNBNTBNNNHNNHNNHNHTHHHBNNBNNBTNHNBTNNBBNHNNNNHNNNTHNNNNNNNNNNNBNNNTHTBTHTTNHTNNNNNNHBBTNBNNN
NNNHNBHBHNNNNNTNNBHNNNNHHNNTNTNNHHNTHNNTHTNNTHNNNTNNTNTHHTHNNHNTNBTBTNHNTNNNTTNHTNNTTBNHNNTNNNHBHNNN
NHHNNNNBHNNNTTBBTNNHHNNBHNNNHNNBHTNNHNNTTNNTNNTNBTTTTTNBTHTNTTNNNTHTTNTNTNNNNTNTHNBNNNTBNNHNHNNHNTNT
TTNTNNNNNNTNNTHNNNNBNBTBNTNNNTNBNNHBNNNNNNNTNNHNNTHHNNBHTNNHTBNTHNNNNNNNTTHBHNNNNNHNNNNNNNHTNNNNNHHH
NNHBNTNBNNTBHTHHNHTHHTNHNNBNHNNNTNHNBTTHHNNNTHNNNHNNHTHNBTTHNNHNNNTTTNBTTNTTNNBHNNTBNHNNNTTNNHTTHHNN
TNTNNNTNNNTNNNTHBNHNHNNNHNHTHTTNNNHNBTNNBHBTTHNNNNNNHTNNNBNNHBNHNNTTTNHNTHNHNBBTBBHNBNNTTBNHNNNNNNNT
HNNNNTNNNBNBNTTNNHNBTTNNNHHTNNNNNTHNHNNHNNTTTHNTNHNTNTNHNBBNNNHTHTHTHHNNTHNTNNNNNNTNNNNHBNNNHNHBTHNN
HHHHTNTHNNHBNNNNTNNHNNNHBBNNHHBNBNNTTBTHNHHNNNHTHNNNNTNNHTNNNNNHNTNNTTBNNBTHHNTHNBBHTTNHNNNTNNHHNHNN
HHTNNTNNNTBTTHHTTBHHNBTNNHTNHBNBNNNNHTNNTNNBNNNNHNNNHNTNNNNNTTBNTNNBNBNHNNNNTNNNNTTTNNTNNTNNNBHBHTNN
HTTNHNNNTNNHNNNNNNBNHHTNTNTNNHHTNNTNHNNHHHTHTNNBNHTNNNNNHTNHNHNNNNNNTNTNHHNNNBTTNTHNHHNBHTNNHNHNHTNB
NHTNNHNNNHHHTNNNNNNHTNNTNTNNNNHNNNHNHTNNHHNHNHNNNBTNNNNHNNNTNHNHNHHNNTNNHNNTHTNNNTNBNHHNNNNTNTNHTTNN
NBNNHHNTNTTNNNNTTTTNNNNNNNHNNTNNNBNHHNTTBTBTNTNNNHNTTNBNNHNNTNNNHTNNBNHNNNNBHNHNTNNNNBTNTNNHNNHNHNTH
NHNNBTNNNNNNBHBHNHTBTNBNNTBNNHHNHNNNNHTHNNNHNTNHNNNHNTNBTHTNNTTNHTNTTTNNHHTNTHHTNHNTTTTHNNNNNHNNNTBB
NHBTHNTNNNTBNNNTNNNTNNNTNNNBNTNHNNHNNHNNBNTTHTHNTNNBBTNNHNTNBBNNTHTNBNNTNNNHBHTNTTTNNBNNBNNBNNNTTNNB
HNTNTHHNHBHTTNHBNHTNNNNNTNNHNNTBNNNHNHNNNHNNTNBNHTNNNTNTNBHTNTNHNHNHHNHNTNNNNTNNNHHTTHBNHHNNNNNHBTNN
TTTNHTNHTNNTHNTBNNNBTNNNNNHNNTTNNHTNNHNNTHTNHNTBNNNNNNNHNHNNTTTNBNHNNNTNNNBTTBBBNBHTHNNNHNTNNBTBNNNB
HTNNTNNHTTHTHHNNNNTNHNNNTTHNHHTHNNHNTTTHNHHHNNNNHNNHBHNNNNNNNNNTTNNHNNNNNNNHTHTNNNNBNBNNHTNBNNNBHNHN
HNHNHHHNHNNHTNTTNNHTHNTTHHNNTNTNTHNHTBNHHNTNTTTNBNHNNNTNTNNNNNTTNTNBTTNNNHTBHTNNNNHHHHNHNHNHNHNNHHNN
TNNTNTHHNHHNTNHHHNTNNNNTHBTNHNNNHBTNNHBHNHNTNNNNNHBHBNTTHNTTNTHNHNNNBHNNTHNNNTNHNTNHTNTHNNNNNNNTTTTN
TNTNHNNHNNTBHTNHNHTBBNBTNHNTTTHNNTNHNTHNBNBNTHNTTHHNBHHNTNHHHNHNNBNNBTNNNNNNTNHTNHNNTNBHNBNBHNNBTTNN
NBTBNNNHTHHTNNNHTNHBHNNHHNHNTNHBNHNNBNTTNNNNNNHTNTNTNNHTNTTNTNTHNNNNBHNHBNTBNNTHTNTTHNTNNHNNNNNTNTTN
TNNHBNTTNHNNNNTHNNTNNTHHBBNNNNTNBNNTTHTHNNBHNHNHTHHHNHTTHTNNHNHNNNTNNNBTNTNHNNNHNTTTBHHNNHNTTBHNNHTN
HNNNBNNNNNTNNNHNNTNTTTHNNHNNTTNNHTBTNHNNNHNHHHTBNNTHBBNTNHBNNNTNBNTNNNNTHNHNNHHNNNNTNBNNNHTNHTNNTBNN
NHNNNNHHBNTBNNNNNNNTNHNNHHHNNHHNNHNHTNTTBNBNNHNNTBTNNTNNHNTNTTBNBBHHBHTNNNNHNHNHNTNHNTHHBNHHNHNNHHHN
TNNTNNNBTTNNBNBBNNBNTNBNNHTHHNNHNBNTNNHNNNNNHNNBHTTTNHNHNNTTBNBNNTHBNHNNTNNHHNNHNTHNTNNNNNHNTTBNHNTT
NHNNNNTNHHNTNBTHNNBNTNNHNBTNTNNNNTHNNNTBHNNNTNTTNNHNNNBTNNNTNNHTTBTTHNNNNNNHHTNTNHNNHNNNTHTNBBTNNNHN
NBBNTNNHHBNNNTHNNNNNHTHHNHNNHTHTHTBNBTHNBNNHNHHNHNHHNHNNTNNNNNNNTTHBTBNNBBBNNNTNHTNNBHTHNNNBNHHTHNTN
TTNTTNBBHHNHHNHHNTHBNNTHTTBNTBHNNNTNBNHTNNTHNNNNNNNHNHBTTNNHNBHNBNNNNHBHTTHNNTNHHHHNNTNNTNBTNTBHNBNH
HHNNNNNHNNTNTTBNBNHNTHNBHTNHNNHNBHBTHHBTHBHNBNNNBHNBNHHTNTNNBNTTNNNNNNNNNNHNTNHNBTNNNTNHNBTNTTNTHNTH
THNTHTNHBNHTNHNTNNNNNNTNNTTNNTNNTHNHNNTNTNTTHNTNTNHHNTNHNNNTNNNNTNNNTNNHNTTNNTTBNBTNNNTTNNNNNNTTTNNN
NNNTNHNHTNNNNNHHHNHNTTBNNTBNTNNTNNNHNBNBTNTTTNHNHHNBNNNBTTNTNNNTNNTTNTBTNTNHHTNTTHNNNHNHNBTNBBTTHHNH
TNNNNNNHNNNNNHBTTNTBBBNNNNNHNHHHNHHNNTTNTBNHBNHNHNHTHTNHTTNTHNNNTBTTNNHTBNNNHNNNNHTHHBNTNNNNTHTHTBNN
