TBNBBHNHNHNNNNNNTHNNNNTNNNNHNHHNTNNNBNHHNTNHTNHNBNHNBNNNNNHNTNHHNNTHNNBNNNHBNBNHBHTNBNTTBHNTTNNHTHNN
BBHNNTNNNBTNNTTNTNNNHNNTBNHTNNTTHBTTNNBTNNBHNNTHTNHBNNHNNNNNTTNNBNNNNHBHNHNNNBNBNNNTNBNNHHNNHTNNHNHT
NBHTNNBHNTBNNBTNTNNTHNNHNNHTTBTNHTHHNTNBBNNNHNBNHNNTNNNHNNNNNBHBBNTNNNBNTHNTBBTBTTTTNNTNNNBNTNNNHNHN
THTNTHNNTNNHNNNNNBHNBNBHTTTNTNHNNNTNTNHNNNNNHBHNHTNBTHNHBTNNTNHTNNNNNNNHNNHNNHTNNHNNNHNNNNHTHNTNHNHB
NHHNNNNNTTHNBNNTNNNTNTNHNTTNNNNTNNTNHNTNTNNNTTNNNNNNHNTNNTBHHHTNTHNHTNHBBHNNHBTBHHHTNNHNTNNNNNNHNBNT
NHNTBNNBNHNTNNHNNBTNBNTHTBTHNNNNHTNHNNNNHNTNBNNTHHNTHNNTHHNBTBNHBTTBNNNHBNNBNNTTBNNBTTBHBHHNNNNHNNNN
NNNBHNNTBTNNBHNNNHNTHNTBHHNNNHHHHBNNTTNNNTNHTTNNBBTNNHHTNNBTNHNNNNNNNNNNTNTHHTBNNTNTHNNHBNNNNBNTHTNT
NNHHNTHNNHHBNNBNNBNNNNTHTBBTTNHNNNHNNTNNNNNNHHNBNTTTHNNNTNNHNTNHTNNNBHHBNNNNNNNNTNNBNHHTTNNTNNNBHNNN
NHHHHTNNNTNNNNNHNBNNNHTNNHNTNHNNTTHNBNNHHBNTHHBTNBNTBNNNNHNNNNNNNTNNHBNNNNNTNTNNBNTNTHHNTHNTNNBNTBNN
TNNBNNNNHTNNNHHNTHTHNTNTNHHNNNHNTNBNNTNBTNHNNBTNBNNNTHNNNTHHHNTBTNBNNHTHNHNBHBNHHNHHNNHNTBNTTNHNTNNN
HHTHBNNNNTHTNNBNNHHTNHTTBHBNNHNNTNNTNNNNBNTHBHNNTNNNTNNTNHHNTNHNNNTTNTTHNTHNBHTHNNNHHNHHTNNNNBNHNBTH
NNHHNHBNBNHNHNHTNTNHTNHNTTHTNNNHTTHNNTNTHNNNTNBHHHTTNHTHHBNNNNNNNNTNNNNHNNHNTNNNNHTNNNNNHHNTBNHTBHHN
NNNNNNBHNHHTNTNNTNTNNTHHBNBNNHNNTNHNHHTNNNHNNNNTTHHBNBBHBNBNNNTHNNHNBTNNNTNBNHNTHTNNTHBTTNHTHNHTHNNB
HBNNHNNNBNTTNHNTNBHHBNHNHNBNTHHHTHNTNNNBTBHBHNHHNNNNNNNNNTHNTNHNHHNBNNHTNTNNNNBNNHTTNNBBNNNNHBNNNTHH
NTHTNTHNTNNTHNBNNHHNNBNNHNNTBHNHTTHNNNHBNNNTTTBNNHNNBHBNHNNBBTNTNNNNBNNNTNNNNNBTTTHNHHNNHHTNHNNNNNHH
TNNHTNBHTBTTHNNHNTBNNHNTHBNHHHTHNTNNNHNBHTNNNBTBHTHNNNTNTNNHHBNHTNHHNHNHNNNHNTBTNHBHBNTNNTHHNNHTHNNN
TNBNNHHNHHTBNHNTNNBNBBNNBTNHNTNHNNBNBTNNTBNNNNTBNNNNBTHTTTNHNTNHNNNNBNNTTNNTNNNHTHTHTNHNNTHHHNHNHTHH
TNBNHHTTNTTTTTBNNTTTNNNHNNNNBHHNTNBHHHNNBTNNTHHBHNTTTHBTNHNNHNNNNNHBNNHNTBNHBNTHHNHNHNNNNTNHHBNNHNNH
HNNTNNBTTNNNNTHTNBHHHNHNTTNHTHNTHNBBBNHBHHHHHTNBNTNHNHTBNHNHNNNNHHBBHNNHNNNNHNNBBNTHNHBHNNBBBNBNNNHT
NNBNTHBHNBNNHNHTHTNNBNNNBNHNNNHTNNHTNTNBNBNNHNNNTNNTNBHHNHBBNTNNTNHNTTHNNHNBBNHNNHNNNNTNNHNTNTHNNHNN
HNTNHNBNBBNNHBHNNTBTNBNNTNNNBNTBHTNNBBNNNHHNNNHNHHBNHNTHNNNNNNBNNBTTHTNNTHBNHBBNNTNHBNHHHTNNNNNHBTNN
HTBHHTNNNNHNNBHHNBTHHTHHNHBNNNHNTHTNTBNHNHNHNTNHBNNTBNHNNNNTNHNHNTTHNHHNNNTNNNTNHNNNBNHNNTHHHBNNNNHN
NHHNNNHHNNTTNNTNNTNNNNBNBTNNNHHTBBTNNNNTHNHNNTNNNNNNTHHNBNBTHNHNHTHNHTHTNNTTNNTNNTNNTTBNTHNTBHNNBHBN
HTTHBNNNNNNNNNTNBNNNTTHNNNTBBBNBNNNNHNTNTNTTNNTHNNTNTNHHNNNNNHHNBNHHHTNHTNNBHNNHNHHTNHHTBTHNNHNTNNNT
HHNNNNTNNHBNTNTTHTNNTNHNHNNTNHNNNNNNNNNTHNNNNNNNTBNNNNHTNNNTHBNNNNTNTHNBBTTBNBNTBHNHBTNTNHNNBNNNNHHT
NNNNTNNTNHNHNNNNNTNNBBNNTNBNTNTTBHHTHTNNTBTNNBHNHNNTNNHBNNNTNTNNHTNHHBHNHNHHNNNHHNTTNTBNTHNNTHHNHNTN
HNNTNHNNNHHNTNNBTNHBNHTHNNNNTBTHHNNNNTNTNNNHTNHBBNNHHNNNHTTNBBNTNNNTNNHBBHHHTNNHNNTNNHNTHNHTNNNHHHHN
NNHTTNNHNHNHNTTNNNNHHBHNTNTNHNTNNNNNTHNNNTHNTNBNTHNNBHTHNHTNHHHTBHNNHHNTHNNNNNNNHTTNBNBNHNNTNNHBNNNN
BTBHHTHNNTNNHNNNNBNHNNHTNNTNNTNNHTNHNNTHHNBNTTHBTNNNBBHHTHNTNNBBTNNNNNNTBTTNNHNTNNNNNNHHNTNTNHHHBNTN
NHNNNNNHNNNNNTTHNBNBTNBNTNNHHBNNTNTNNHNNHNHNHNNTNNNNNTNHNHNNNNNNTNTHNHNTNBNNHTTNNTTNNNBHNHHNNTNBNNTH
HNNTHNNNTHNNTBHTNTNNTTBNNBBNNNHTHNNHHTBNNNNNNBBNTNNNNNBNNHBHHBHHNNNNTTBNBBNNTNNHBNNHHTNHNNTNNTNHTHNN
NTNTNHBTTTHHNBNHNNNNNHNHHNHTTBNNBNHNBHHNHTNNNNNHBNNHHNHHTNBTNTHBTHHTTHNBTNNBNNTTHBNNTNNHHNTNHHNNHNNN
NNHNTNTNBHBNHNNBNNNHHHNTTBTNTNNNNBNTHNHNNNTNNNNHBTNTTTTNHNBTHHNTTNTHTHHNTHTNBNTNHHBHNNTTHBTNNNNNTNNN
NNTHTHNBNHTNTBTNNTHHNNNNNHNHHNNNTNHNNNNHTBNNBNTHNTNHNNHNTNHNHNHTHTHHNTNNNHNHNHTHTHTTNTNHNNHHNTTTBHHB
BBHNHNNHNTNNTTTNNHNNHNNNHHNNNBTTHNHHNNNNTTHNHNHNHTHTNTNHBNHTTHHBTNNHTNNHHHNHTNNHNHNNNTNNTNNNNNTNNNBT
NNBBBBTNNTHNNTNNNNNNNHHNNTHHHNNHTNHNTHNNBHTNNTBTTTHHHBNHNNHNNNHTNNTNNNNTTNNTNNNNNNNHNTNBNNNNHTNHBBNN
BNTTTBTNNNNHTTNNBNBTBHNNHNNNTNNHNBBTNTNNHNNBNNNNTNTNNNHHNNBNBNHNNNHBNNHNTNNNNNNNHHNNNNNNNNHHNHNNTHNT
NTBNHTTTBBNTNNNTTNNTNNNNBNHHNTHNNNBNTBNHTTTNBTNTHNNNHTTNHHNNTNTNNHNBHNNTNNNNHBNTHNBNHTNNBTNNNHHHHNHT
HBNNNTTTNTNBHTBNNNNNTNNNTTNNTNHNHNNTTNNBNNBHNBNTHHNHBNTNNNNNNNBNNNHNBHNNBTHNNNHNBNTNHNHBHNTNBHNNHHHN
TNTTHHNNNNHHBTNTTNHNHHBHHHHHTNHTNTTNHHBTTNHNBNNHNNNNNNNNNNNTBNTTNNTNHNNNTTNNHNHNNNNNTTTNNNNHHNTTHNTT
HBHNTNNNNTNNNTNTNNTNHNHBTHHTNTNHNTNHHHTTTNNNNHNNTNNNHHNBHTHBNNTNNHBNBNNNTNTNHBNNNNBBNNTBNHHTHBNNBHTH
HNHNHBBTTTNNNBNNNTTNNTTHNTBBNTTTNTNTHNNHTNHNNHNTTTNNTNNNTHBBTNNTNTHNNNNNTNTNNNNNNNNHTNTNNBNNBNNHNTNB
NNHTNTNNHNNBHTTNNNNTNTHTNHHNBTNBBNNHNNTNHHNTHNHHHNNHHNTNTTNNNNNNTTTNNBTHNNNNHTNNNTNTBBNTHNNNNNHNNNTN
NNNNNNHNHTNTNBNHNTNTNTTBTTNHHBTNHTNTTNHNNBNTHNHHNTTNNBNHTNHNNNBHHTNNNBTNTNHNHNNNHNNHTNHNBTHNHNTNTTHB
NNTBHNNTHNTHTNNHNHTBNTHBTHNNNNNNNTNNNNHBHHNNNTNNBBHTNNBTNNNNHNNHNNHHTNHHHTTTTHTNNHHBHHHNBTTNNNTNTNNH
NNNHNBNBHNHNNNNNHTNTTNNTBHNBTNTBNNBHHTNNBNHTNBHNNHNNNHHTNNNTHNNNNNBBNTNNNTTNTBTTTNNHHNNNTHTNHBNNBTTT
TTTNNHHNNTHNHHBTTHHTHNNNTBHNTNNTHNHNTNTNTNTBNTNHHTTTHTNHTNNHNNTBTHNTTTNBNHHNNTHHNTHNNNTNNNHBNNHTTTBH
HNNBTNNNNHNTBHHNTNNNNBNHHHHTHHNNNTNHTTTTNNNBNNNHHTNTTNBNNBNHNHNBNNNBBNNTHNTBBNNNHNNTBHHTNNNNBNNTTNNT
NTNNHBNTBHNHNHNNNTNTNHNHNHHTHHHNHBTNNNNHHNTNTBHNNNHHBTTTNBTBTNTNNNNNHNNHHNNTNNBTNNNTNNNHNTHTTNBNNNHN
NNNNTTTHNHNTHNHNHTNNNNHNNHNNNHBHNNTNNHNNTHTNNNNTNNNNTHBHNNNNNBTNTNTHNNHTNNBNNNNTTNBNNHNHTNTNNHNTTTTT
NNNNNNTTNNNTNHHNBNNNTNNNTNNHNBNNNTNNNNNNNHNNTNNHBHHTNNNNNBTNNNTNHHNNNNNTTNTNTHNHTNHTNBTNNTNNHNNBBNTB
HNNNNNTNTHHHHNNNHNHNBTTHNHNNHNNBTNBNNHNHNHBNTNNHTTHNBNBTBHNHNTTTBNBBNNTTNNHHHHTHNBHBTBNNNBNNNTNHTBTN
HBNNNNNNNNNNTTNNTNBHNNNTHTNNHTNNNTNHHBBNNNNNBHHHNNBNNNHNHNTNNHNTHHNNTNNNTNNNNHHHHNNNHTNNNNNHNNHHHTBN
TNBHTNBNNNNNBTHNNBHNNHTHNTBHTTNNTNHHNTTNBBHNNTTNTNNTNHBBNNHNNNHTNNNNNNNTHNHHNHTNNNNNNTNNNNTNBBNBTNNN
THNTNHTNTHHHTNNBNNTNNNBHHBHNNTNTHHNHNBBNNTNNTNNNHNNHNTHNNHTTTNNNBNTNNNHNNNNNNTNHHNNTNNTBNHHNTTTTHNNN
NTNNHNNHBNNHHNHNNHNNHTTTNTNHNHNHHNNNHNNNNNTHHHTNTNNBNHNNHNBHNNHHTTNNTBNNTNHNNNNTTNTHTHHBBHNNHTNHNHNN
NTNNNTNHNHNTNTBHTNNHNBNTNNBNTNTNTNTHNNNNTNHHHBNNHNNNHNBNNTNNTNTHNHNNNHNBNTNNTNNHNNNNNNHNBNNNNBNBHHNN
NNNNNNNTBNHHNTTTHNNNTHNHBNHNHNNNTNNTBTNTNTNTNNHNTTNHHNNNNNNBNNBTHNBBBNTNTNNNNNHNBBNNNHNNNNNTHNHNHHNT
THNNTTTHTTNNNNHNNNNNTNNTNTTNNNNNNNNNHNHNNNHBNTHNBHTHTNNTNNNNNNHNNNHHNNNNTNTBHTNNNNNHBNNNNHTNHTNNTTNH
TNNBHNNNHNBNNNNNHTTNBNTNTBHTNNNTTNTNTNNNTNTNHBHNNNNNNNNNTBNNHTNNTNNNTTNBHNBTNHHNTBNNNTTTNNTNNNNTHNNT
HHNNNHNNNNBHTNNNTHTNNNNHNNNHBNHNHTNNNHNTBTHNNHHTNHNNHHNNTTNTTTNBTBTNNTTTNNBNHHHNTBTNBNNTNBHTNNNHNHNH
BHNNBNNTNNNNHHTNNBHNNNNBNBTNTBNNTBTNNHNNNTNHTHBNHNTBNBNNBNNNNNNNTHNTTNTNHNTBNNNTBTHBNTTNBNBHTTNNNNTH
TNTNNTNNTBHNTTNTHNNTHHTNNNNTNNNNNNTHBNHHNNNBNNHTNNNNTNNNTBNHNHNNNNNNNNNNNNHNTNNTHNNBTNNHNBNHNBNNNHNH
TNNTTNHHNNHTNNNHNNTNNBTNHHHNBNNNNNNNNNTHHHHNNBTTNHTNNBNNNTBNHNHHTNTHBNNNNNTHTNNNNHTTTNBNNHNNHNTTNTNH
NHHNNNNNHNTTNTTHHNNHHTNHBHTNHTNNTHNTTNNNNHNNBNTHBNNNHHTNNNNHNHHTNNNHBHNNNTHNTNHBHHNNBTNHHNHNTHNTBTNT
NNNNNBHHNTNNTTTTNNNNTTNNNNHBHTNNNNNNBHHHNTNTHHNHNTTNHTBNNNHNHHHTBTHHNHNNNNNTNHNHTNNNTTTTHTTNHHNBTHNT
HHBTNNBBHNNTTTNTNNNHHNHTNNNHHTTNHHNBNNNNNHNNNBTNNTHNNHNTNBTTHNNHNTNNTNTNHNNHNNTTNHNTNHNHNBTHBNNTBBHH
TNTHNNNNBTNNNNNHNTHNHTBNTBHHTNBBHHNHNTTNBBTNHNNNNHNTHHNHNNNNNHHNNTHBNTNTTNTHHNTHNTNNNNTNTNNHNTTNBHNN
NNHHNNNNNNHHNBTNHNNTNNNHHNBNHHNNNHNNTBHNNTTNNHBNNNNNNNHHTNNNNHNNBNNHBNNNTNTNNNNBTNNNHNNNNNHNTNNHNTNN
TNTTBTNHNHNHHNNTNNTNNBHBHBBNNNNNHHBBTHTNHBNTBNHNHBNNTTNHHNNBBBBTNHBNBNTHNHTBNNBNNHTNNTHNNHBTBNNHNHBN
NNHHNTTNHTNNBNNHHNHNNTTNBHBNHHBTHNNHNTTNNNNNNBHTTBHHTTHTBHNTNBNNNTTBTHNNNHBBHTTNHNNNBBHNTNTNNNHNHNHN
NNTNHBHNNNBNHNTNNTNNNNTHNTTNNBNTBNHHHNHNTHHNNNNTNHNHTTTNNHNTNNNHHNBNHBNHNNNTTNNHNBTHHTNNNNTHNTNBNTNT
NTTNTNBNNNNBBNHNHNBTNNHTTNHBTNTTHHNBBNBNHNNBTTNBBNTBTNBNHNNBHNHNHNNTNHHNBTNTNBTBNTNNNNHNBNNHTNNBHHNN
TNHNHTNBNNBNNTNBNNHNTNNHNHNTTTNNNHBHNTNBTNBHNNHNNTNNTNTHTBNBHNHHNNNNTHNBNTHNNHHNBHNNNTNTTNNNHNHNNNHB
NNNNTNNHNTTNNNTTHNNNNNTNNNNTBNBNNHTNTNNNNHNTNNNNNTBNNNNBNBTNNNNNBTTTNNNBNHHBNNNHNNHNHNNNNNNHNNNNNTNT
HNNNTHNHHBTNNTNTNNHTHTNNNHNHNBNHHTNHNBNHNNBTNTNTHNBBTHBTTNHHTBNNTNNTNNNTTNNNNNBNTHTTTNHNHNNTBBNNNTHN
BBNNHHTHNNNNHTTNNNNHNNBNNNNNTBNNTBHNHHHBHNNHBBTTHNHNBNTNNNNNBHNHBTNHNHNNNTNHTNBHNHNNBTTNNBHHBHNTHNHN
HNNNNNNTTNTHNNHBNNTTBHNNTTNTTNNNHNNNNBTNNNNNNTNTHNNHTNTBTNNHNNNTBNTNHNNTHHNHBNNNTNNTNNNHNBNBNNNNBNHN
NNHNBHHNBNTHTTNNNTTNHNTTTTTHBNTNTNTNHHNNNBNHNNNNHHNNNNNNBHHNHNTNHTTNHNBNNBTBNNTTNTNHNNTHTNTNNNNNBNHT
NNHHHBNTHNHHHTNBHNBTNHBNNBTHHHNBHTTTNNNNHNNNHNNHNBBNBTNNNHNNBNTTNTNHNNTNBNHTHTTHNTHNNHNNTNNTNTHNHTNN
NNBHTHNTBNNHNHNTTNTNNNNTNNHNNNBNHNHNTBNNHNTNNNNTNNTNBHTNNTNTNNTNBHHTNHTHHNHNBNTNNNBBHNNNNTNHTNTNNBHT
HNHHNNTHNBTTBNTTHHTNBNTNTNBNHTBHNHNNNTHNBNNNNHNHNNNNHNNTTNNHNHBTHNHNTNNNHNTNNNBNHBTNBNNNTNNNNHHTNNHN
NBTNBTNNHHHNNTNNNBBNNNNNNNHTNBNNTNNNHNHHTHNHTBTHNNBNBNBHNTBHTHHTNHHHTNTHBNTNHNNTTTNNNTTTNNNNNHNNNNNN
NNTBNTTNTNTNHHNNNTHNNNTNHNNNNNNHTHHNHHNBNHTTHNNHNNNTTNNHNHBHNNTHBBTNTBTNTTBHTNNHHNBHNNHTHNNNHNNNNNNN
HBBTNNBNTNTTTNHTBNNHNTNTBNNNNNBHBNNNHTTHHNTHTHHHNNTBNNHNBNNNHHNHBHNNNNHNNNTBTHNNTNHNHNHHHNNTTNTBNTNT
TNBHNBNTHTNNNHNNBNBNTHTNHNNHNNNTHHNNNNNTHTBTHHHBTNBBBTNHTNNNNTHHHNNBHBTNNHTHHHTHNTHBHHTNHNHHNTTNTTHH
NHNHHNTTTHTNTHNTTTBNNHNNHTHTBNNHNNNBNNNHHNHNNNNTBBBTNTHTNNNNNTNTNNHNNNNNNNTNTNBNNHBHHBNBNHNBHHTNHBNH
THNHNNNNNHHNTNNTNNNNTNNTNNNHNTHNHHNNBNNTTNTHNNNHNNNHTTTNNNNBNNNTTHNTHHNNTTNTHTNHNNNNTTNNHHNTNHNNNBTN
NTBTNHNHNHHNHNBTHHNTTHNNHNNBNHNNTNHHNTHBNNNTHNNNTHTNHNNNBHNNNNNNNNNBBNNTNNNTHHHNHNNNTNNNNTNTNTTNNTNT
NBNNNNNBHNHNNNHNNBTNBNHNHNNNTTHNNNHNNBHTNTNNTNNNTTTTBTHTNBNNNBNNHTNNBHTTNHTTNBNHNHNBTNBNNNTTHTNNTBHN
NHNNNNNNTHNNNNTNTTBNNNNHNNNNNHNNNTHHNNNNNTBHBBNBNTNTNTNTHNBHHTTTNHBNTNNNNHHNNBTNTHBHHHTHNNBNNNTNNHNN
HNNHNHBNTHNBNNNHNTNNNNNNNNNHNNNTNNNTNNTNHTHBBTNNTTNNTHNNTNNNNTNBHNBTNNNHTHHNNHHTNNNBTNHNNNNNTHNNBTNH
BNNTNBNTNNTTNNNHTTHNHNTBNNNTNTHTHHHNNNBBNNNNTTNNNNNNNHTHNNTNTTNNHNNTNTNNBTNNTNNNNTNTBHTNTHTNNBHNNNNH
HNNNTHNHHHNTNNNNNNNBNNTHBNNNHTNTNNTBTNNNNNBHNHNHHHNNNTHNNNNNHTHNNTNNHHNNHNNNNNTNHNNNBNHNNHNNBHNNTHNT
NTNBHNBNBNTBTHNHHNNTTBNNBTTHNNTHTNNNTHNNNHNNTNNHNNNHHTNNNHNNNNHNHHNBNNNBBNHNNBTBNNHNBTNNTNHHTNHBNNNN
HTBHNNTNTTHNHNHNNNTTNTNHNHNTNNHHNNNHNTNNNNNNNBNNTHHNHHHTHBHNHTNHHBHBTHTNTBNNBNBTTHNTBNNTTNBNNNNNTNHH
HHNNNTBNTHNTNBNNHBNTBHNTNNBNBNBNNNTNTNNNNNTNBHTNBHNHNNNNNNNBBNNTNTNNNHBNBNNBBTNTNNHNNHNHNHTTHNBHNNHH
BNNTTHNNTTTTNNNTNTTNNTNNNHTHBTHNNNHHNNNNNTNTHNNNNTHTNTNNNTNHTNNTHTNHNHHNBNNHNNTHNTTTHNNNNNHNHTNNTNNB
NTTNNNNNTNHNNNNNNNNNHNNNTBHNNNTBNNTNNNHNHNBNTNBHNNHTNHTNHNNHHBHHHTHHTNTNNNNNHHHTNTHNNNTHHNNNHBNNNNNT
NHNNBHNNHTTNNHTTNNNTNHNTNNNNNTNTNBTNBNNNNNHTNNNNNHBHHNNNNNNBNNNNNTNTBTHTNNNNNNNNTNNTNNHNTNNTHTHTBNNB
