1332131103121131133111121312111111110232311112131211121201013113111132131111320131302131321230111112
2310131122123211311133201111231120111030212111111302111110130121010121211211210021311311133020321112
1331113310133133111112232120111110113311312011111111333131123112021301131010211211223133013212112330
3331231112111113111323311111113131320133120111312313121312133211333102111311212111232211221313111131
0122223232102310112323331311131111011132231112112110112103113210120133133033113132111112131111110032
1111113112331212311112031111101311311301131222112300111211112111222111111322121123312122111211313321
2112131121131121112111111121211321313303323113112223111121111023313111110113111331311121222122221012
1231012010121221131132130112231103211223133123133233213131110031113111111132323112103321231103112102
3111111212111231011132311313023123012111110230312031103133122313113111111121311202121121101311111211
0211311212121221111121110230132111311130133121212123122132111212130222211111121131211110023111311111
1221131322111131012312210122311111111133121111212210113131010232112113220103312112321133210121123313
2222212110111121111202330102111232312122331330313312131112231131121023113211012211022122113111011123
2313111223231111122103231111313123302113231111303110211020121131131212212231112101110103132111111110
3031310110211012112031111121122311213231213113332122131311310113112333232013100211111201213201221111
3101220111321111112212120112021131010331331211111122311101322121211231301101011113111111211311113132
3200132112121310121101121121211110331310133331300132033311211310111112111021111021112113113111331021
1131001313321213121031113112113323133111010112112123302211121022313112231311312131312111301011130102
1132110121311131211221112233111233221311113113121101113222021131011212111121111311033211131021211311
1221113121001120111131113132113221011133212321133330100221101232111121311313111011111121121311311211
3033101102101311100121110303311111222211131011112111000113111213131120321111121303111123232113211310
2311331133201331110111111211131103203213013012112101130232023311111122113021212130313212321321122010
3312111321233133201221133211212113211111303112230101010111233011111112110222232131000113133301211120
1112311021232111110031100123221213303230103202223011113121111131113230002131113021111301111123131111
2332221311131131211311311133031310310010233331101110312112113222133122310133213112112231102110312102
2213123011112110111131121120131323302111111031211133111112121031213211111112211310021301311111121110
2311131212211123223111221121131322111331001212211111131131113210213331112213021121131221111313113110
2310113123211031331213133331130112322210110231311113111011212211120033031112131000131303111121123321
2213310111213201120311211022132333132332331200311311312332023113321111011121110312211111103121223320
3123113110112123221313133111331312031133111112111331023113131310213211211111331012031112321231131131
2021001232111313231011110111131310121132321231212002230112220112230331011111111210112032110211220113
2111311213312001313221110121133313102112110121103333111113301101131111121112123111321213133101321300
2013113312111321111111321123232031122111111111132311013120233111111320131110113121312313132211013220
1311213101313121220310223113011013311311111311213110331103123111221111113112101103311111101231101121
1111220113221112100111321101122221011111121110123132123013013113121301312223123021011131213211112011
3113112311211110131111112210201113110333111210133212313111313102121110121023111311232311131131111211
0213102111113302120101121211101101111112111213111312131112312220322111011221301331122113033121312123
2112113131230212111212211123322131113133211121221213011321310213011211123211113311133232131322020021
2111112112131133011331331012112311201131011101321212211300132113111113112221231101111111322313111312
1010110123100202111131111012200113211111130231222131122121010210331220321112221211231101203311101211
1323111131332021311101211033133113331321110130123111311311313131101213313310210130311201121311111211
3111102131121111112110333313121211113111112313131011310111213110212333212131212001123221021321322111
3111111113131231211011021130111001102133313322131311212002311322211231111011120231112213013201111111
1100113111113113103313311332131111113131121322212111211331133111113001112121112011201301011133011211
2213112131121111323110112110121111323111333111221221111210321322311332212212131111311013011113211111
2112133310023011331111123312121122222112110132110111333111121331201302311113321111131303131122113113
0313011111220111023121331030011122302111313232323311111322320111213130131311232112031312312311111113
2111212221111201111111112100211101122011101311331311132221012313321211111331133211013323101110321211
1011010131131011111123111321112213331321321330111111013121132120111131202321211013203211211100231131
2310113131101121311003132331131211311231121102111131213213212111111111212111211130231123313112122323
1033111112131323002112130123111111321112311221121321121013111211031211113200311311133312330223311221
2211110111201112020131220131310323231120111112011220310110110321211113123131312111112111311210201113
1321312211121010231321113131300013012303112110101113211002122103101133333113231311211312121131322200
0110110313111113331112122103103223031213211100110233113011313111101323101111113311022103213211331113
1312222101123121111213221110121201021111331131321102311110123111112212321302131121010021001221213103
3212131311113311111331233331101110111211123312211230321101132212321121131111331322231103330121312022
0311231202210131111121101222122200312131211111232131131131322321211223132311101121113120022121121203
1111331311232032113033330101111232301320120221111121111211131013112321221311121221113320112113110112
2110113112130331313011331132011231231331111210223331331312232301131121311113102113110121111031011121
3311132230111032133232323222211031112111132312221222212112311233121110203121122111321111111201301313
1133221203113010101130110301123111110121222220111321123221113332110112232013121111311201312031113113
2323112221100133012311221013111121013111120110321131111030323123311232132111101122111213231120121121
2321113111100112103121131103311012211120013221111011212331021200221111211110113231321312110111332200
1121233022102121220032221202323111013122111101231113211123301111011123111111320133123011112212313313
1121211113331303321130111011111032113133233210212121100322012111110130110121311331111131011312211301
1220312331111312131032111300113101211012111121221130121322001031032311131113110312121101211112201011
3131121113211021311231323011330111223113013123323032331111121211022131013211110131321311211111111332
2111211310131013102113121211321210231311311133101211121001211233223111321231011111111311123111121222
0121113301312113121311131213313113120131200311132233312111111121011232331203311111131211021311331123
3131130311301331121122333210331111111311011131212111122113133103110111121312213313121212010130112131
1212111131213111233311112001001111233322321111110120211111230111133123212301331013230313233212111120
0111131210001111111123013111131211212312121232131110312311112311111301010122102101110113222113130210
2111111130201211213313122111231130022111222312131022111221131121221321131222131201331023110230112111
1312121103110100212231002021111111022113112113130310131112212121232301221100111011131111211033131211
1001323333311122322302111111111110132311112211112111331112322210211111123301221031113113132131312031
1233131131123111313302310111012120111011031131121112000111321221211331311120111113021113322131111332
1133123022211302212312211311311023133131012213032110221123132131111011113313312223100111123032012031
3231111113201311322212011121113111111111022122201110222233311132122301333111213113222131200313310112
2111033110232322132113333301311012111121311321231221232121123331221123121322021111121212001231111111
2012121332211213132123113223331111102130331120112223031312313111313123231212110101131013232113301113
2031110121131311311321113113321211313211111113211311331131131023312111123312121121120122131111111111
2221322131012111111101033211111110103311330111212121111133311303112100011020013013311201321121212132
1132121033133021211113103131120112011113111112023111211111223121123111333111201113111312120313131232
2110111111113211113212211111133011011103231131112310311111313311031331111113112122230110120211321000
0132201231312333131132112131331111231132011012211111320312131100330321131112211111121112011222101111
1301313011121132111111131312311311103111131101301122131132112222112221211101011310321310110132312112
2132132213211003231211120321211212131131123022132112111311203111330113110133112121313321232333011211
3130111332311113112123131012131332232313101121131111220213121111131111111311211211021111231132212220
3132112311311111122212210320111120321312110132311110111321231110312220311112321033113233211211133120
2012111030210123202130030211012132213111331223111321211331330322311212110121131012131111010111221310
0111312311111323323111212110132012132113231123010222121111112120331011121131111310113232012110111211
2110211312031101310103101113113213332121303021121311102202223122112110101132313331311112131311111333
2311212113113130110013311221111101113212323122121112111021112133013111112301103113311311133101001123
0211102013131321111210211331112211113322111110011122301333311330211301132331332101111132102123313131
1213111212211210121123221211220111031110111212113311111201313313322110312013311323133222003111231311
3311231133313012002221021333313332211013111003011121320311121311221131113031303333131201210110113313
3211111011112221311310111133112323113111221112311102103111113111320111131122111111001211111221301112
1111132130122131210121133031112000101012121011111301311113200111030110210112103013321111230221111331
1121123213112331011012103112122102011112301102113311121303112121212322111111311312232012032112313311
1101111111231221111301221131210222111211211113101111111121121013121220113112123101131111111301313123
1211232113212111132131130131113113111101021212221100111111113102111111233103313212101110210313132001
