HTTNHHTTNNNHNTNNNNBTBNTNNNNNBTNNBTHTNNHNBNNBTHBNTNNHHNNBNTBTNHNHNTBNTHTNHBNHNHNNHBNNNHNBNNHTNNNNNNNH
THTBTHNHNHHTNNNTNNNHNNNNNHNNNBTNNHTBHHTTBNNNHHHHHNNHNHNTTNNNHNTNNNBNNTNNNNNHNHNNNNNNNNHBHNHTHNNHTNHT
HNBNTNNTHNTBBNHHHHNNNHNNNTBHTNTNNNBTNHTNBNTHHNNNNTTHBHHNHTHNHHNNNNBNNNNBNNTTBHTTNTNHNNNNHHHNNHBHHNNT
HNNHNNNNNBNBHHNNNNNNNHNNTBNHNNNHNTHBNNTNNNHNBNNNNNTNNBNHNTNBNNNNNNBHNTHTNNNHNTNNNNHHHBTHNNNTBNBTNTTN
HHTNNTHTNTTNTHNNNTTTNTNNHHNNNTNNHNNNHHNNNNHNNBHNNTBNNNNNHNTNNTTTTTNTTTNHNNNTTTNBNTHNHNHNNHNTTHNBTNNN
NNTNTNTTNBNNHTNHNHBNHNBTHNNNNHNNNNTNTNNNNTTNNHTTNNBNTNNNNTNNNNHTHNTTNHTNBTNNNHNNTNTHHNTNNTNNBNHTTHNN
NTTNNNNNNNTNBTNNNNNNNNNNNTHNTTTNTNHNNNTNTHNBBTHHNNNBNNTTHNBNNBHNBNNTTNNNNBTTNBNHTNTTTTTNNTNNNTTNTHNN
TNNHNNHNHNNHNNNHNTTTTNNNTBTHNNNNNHTBTNTNHTNNNNNNNBNTNNTTNNNNTBTNTTTHTNNNHNHHNBNNHNTNNTTNBTHNNNNTNNHN
HBNNNNNTNHNBNNHHBNNNTHNNBHHHBTNHNNBHTNNNNNNTNNNTNNNTHNNBTTNTNTBTHTNTBNHHNBHTTTNNHHHNHNHBHNNNHNHTNNHN
BTNNBNTTNTNNTBBHNNBNNHNTTNHNNHNNHHTNNTNHTHNTNHNTTHBNNNTNNHNBBNNNNNBNTNNTNBNNNHNNBTHNNTHTBNNNHNHNNHNN
NBHNTNTHHHNNTTNBNNHTTBNBNNTBNNNHNNNNBTNBNHNNNNHNNNTNHNNBNNTBNNBHTHTNNNHNTNNNHHNBTBTTNTNBHTNNTNTHHTTN
BBBNNNTHBNBHNNNNNTTHTNNNNNNNNTNNHNNNTBNNNNNNTNHHHTNTHNHNBTBTTNBBHHNNHHNNNHTNTHBNNHTBNNHTNNNNNHHNBBTB
HTHNNBNNNNNTNNNBNTTHTNNHHHNTTNTHTNNNNNNNNTTNHNBNBNTHHNBNNNNHTBTNNHNHTTNHNNNNNNBBTHNHTNNNHNNBNHHNNHTN
HTHNNHTTNNNNNTHBNNNNBNTTNBHNNNTBNHNHNNTNNTTNNNNNNNNHNNHBNNNTBNTNNTNBHTTNNNNHTBTNBNNTTHNNBBTBBNNNTBNN
HNNHBTTNHNNNNNNHNHTHTTNBNNBTHNNNHNNNNNNNHTNTNTNHTBTHHNHTHTNTTNTNNHTTNNHNNHNHTNNNHNNBNNBNBHBNNTNHNTBT
HNTNBNNHBHNNTTNNTNNNNHNNNNHNHHBHNNTTNTNNHNHNNNNNHHHBNNNBNHNTNNHBNNHNTNHNTHBNNNHBTHHNNNHTHBHBTHNNNNTN
NNTNHTNHNNBHNNHNNHHNTNNNBHHTNNNHHHTHNNTNNTTTHTTTTBNBNNNNTNNNNNHNNNBNHHTNNNTNTTNHNNHBNNHBNBNNNTHTTTBH
NNNNTTTTHNNTNTTBHHHNTNHHNNHNHTNNTNNHNBHTNNNBBHTNTNNNTNHHHTNHNNNBNNNHBNNNTTNNNNNNNNNNTNBBNTNBHNTNNNNN
NNNTNBNHTNNNNNBHHNNNHHNBNNTBNTNNNTHNTTBNTHHTBBHNBHNNNTNTNNHBTNNNBNNNNNTNBNNHHBHHNNNNNNNNHNNNHNHTHNNT
NHTHNNNBNBNNTHNNHBNNHHBBNHTNHBHNNTTNNHNHTNBBTHNHTBNNTHNTTNTNTNNTNNTNTHNTTNNTBBNNTNNNTBTNHNHTTNTNTHNT
BNTNTBTNTBTNBNNNNNTNHTNBNNBNHTBHNNBNHTNHNNNNNHNNNTNTTNNTHNTHTBBNNNNNNTNHNHNNNNNHNNBNNHNBBTTNHHNNNNTH
HHNTNNNNTNHNNNHNNBTHTHNNNHBNTBNNBNHHHBBNNTNNNBNHHNNNNHTNTTBBHNNTNNNTTHBNTHNNTTTHTNNNNNNHTNNNHTNHTTBN
NNTNNNNBTNNHNBTNNHNTNTTNNNHNHBTHHHBNHNNNHNHHNNTNHTNNTHNBHHNHNNNNHNNTHBNTNNBHNNHBHHNNHNBNNTNHNNNHNNHN
NNNTNTNNBHHHHTNBNHHHNNNHNHNNTTTNNNNNHNNNHNNNTNTTHNNNHNHHNNNHTNTHHNNBTTNTTNHNNNNTNBNNTNHNTNNNNNTNNTHN
HNNTTHNNNBBTHHNNTNNNNTNNHBBHBHNNHNHBNNNNNTTNNNNNHHNBNNBBTNNNTNHNTNHNNNNBNNHBNNTTNBHHNNNTHNNBNNNTTHNH
BNNHNTNBBNTNNNTHBHNNNNHTNNNHNNTNNNNNNTNHHNNBNHNNTTBNHNHHBNNHNBNTNNNHTNHBNNNTHNNNTTNHTNNBHTTNNHNTTNNT
BTHHHNHHNNBHNHNNNTNTBTTHNHNTNNTNNTNTHNBTHNNNNTHHHNHNNHTNNHHBHNHNTNNNNNNNTNNHTHNNHTNHNNNTNNHNNBNTTNTN
BBTNTNNHTNTNNBNNNHNHNNHHNTTTNTHNNHBTNNNNNNNHTNBTNHHHNNHBNNBHNNTNNNNHHTNHHTNHNNBNBNHNBNBTHNHNTNTBNTNT
BNNHHBTNNNNHTTTNNTNTHBNTNNTNNBTTHTTNTNHTNTNHNNBHTNNNNTNTNBTHBHNTNNNTNNNNNNBHBTBNNBNNNBNNNTTNHBNNBNNN
NTBNHNBNNNTNHTBTTBNTNBTHHHHTNNHNNNHNNHNHNNTBHNHNBNBNBTHNNNHNNNNNNNHTNNNBNNBHTHNTNTTNNNNNNNNNNNTTBTHT
BNNNNNHBNHTNNHTNNNTHBNHTNHHNHNNTNNHNNTBNBNTNNHNHTBNNNNNTHHNBHNNNHNNBNNHNTTBBTTBHHTNBNNNNTHHNNNTNHNNN
TBHTNNBTBHNBNTHNHBTBNNNNNTTBBHNNNNTNNHHTNNNTNHHNHNNTHNHNNNNNTHNHNHNNNBTNNHNHBNNNTNHNTNTTNTNNNNNTHNNT
NTNBNHHNTTHTNNNNHNNNNNBTTNNNNTBNNNBTHNTTBBHTNNNNHHHHNBHNNHTNHTHHHHBNTNHNTHNNTHBNNTNTNNNHHNNTTNNNHHTH
BNBHNNNHTNHNHNTHNTTHNNHTNNHHTNNHNNNHBNNNTNHHNNBTNTNBHNTHBNHNNTTHTTNNNNTHBHNNNHNNNNBHNNNNNNHNHTBHHHTN
TNTHNHNHHHHHNNNNTTHHNNHNNNNTNHNNTNNNNBTHTTNHNTNNBTBTHHNNHHHHNTTTNHNNHBNNNTBTNHNBHTTHHBTHHNNNNHNBTTHN
NHTNHTBNNBBNTTHTBNBHTHBBNNHNBHNNNBHNNBHNNNNNNNTTHTNNNNNNHBHNHNTHTHBNNNNHNBNNNHNTTTNBHTNNBTHHNNTNNNNN
NNHNTBTBNHTBNNBBNHHHNNTNNNNTNTTTBTNNHBTNHNNTNNTNNTBTTNNHNNNNNBHNNTNHNNNTNNNNHNNHTBNNNNHNTNBNHHTNNHNT
NNNTTNHNNBNBTNTHTHNNHTHNHNNTNHHNNTNBHNNNNNNHBNTNTNBNHHHNNNNBBNBHNTHBNNTNHNTTNTNNNTNTTNTTNNNTNTNNTBNN
HTNNTNNNNHHNTNNNTHBHBNNTNNTNTNNNNNNNNTTTHBNBTTNNNBHNHNHNTHHNNNNHBNHNTHTTNTTNNTBBNBHNTNHNHTNTNNNTHNNN
TNNTNNNBTTTNTNNTNHTHTHTNTNBHNHBTNNHHNNNNNBHNNNNNHBHTNHNNTNHNNBNBHHNTNHNNNHNHNBNNHNNBNNNHNBNNNNNHNNHT
THNHBHTBHTBHNHNNNTNNTNTNNTTHHTNTNHHNNHNTBTNBHBNNNTNHTBBNHTNNHHNTNNHNNNNNBTTNHHTTHNHHNTNBNTHHNTTTTNTT
TNTNTNHNNTTHNNTNNNTHBHNNNTNNTNNNTNHNNNNNNNNNNTNHNBHNNTTTNHHNHNNTTNNNHTNNBHBHNHNNTNTNNBNTNNBTTTNTNHNH
HBNNNNBBNNTHHTNTBNBHNNBTNBNTHTNTHHHNTTBNNNBNHNHBNNNNHNNHNHNNNTBHNTNHNNNHHNTNBHNBNNHNTTHTBTNTNNTNHHTN
HNNHNBNHNNNNNBTNNTHNNNBHNTTNTNNNNNBNNNTHNHHTNTNBNNNNHTBNNHNNNTTNTNTTNTNNBNBNNTNNNBNTNBBNBTNNNNHTBBTN
NBHNNNNNNHHNTTNHBTNBHTHNNTHNHTNBHHBNNNNNTNNTNNNHTNNHNNNNNHNBHHHNHHNNBHNTNTBBNHHHHNHNNTNNNNNTNNNHTTNT
HNHTNHHNHTHHHNNNNHBHHNNNBNBTTTHNNTBHNNNNHNNNNNNTTHNNNNNTHHNHBNTBTTTNHTTNNTBNNNNNBBTHTNNHHTTHTNNHNTTN
TBTHTTNNNNNNTNNHHHHTBTBNNHNNHNTTNBNTTNNNHBNNNBNHTTNNTNBBNNHHHNNBNBNNHTNNBNHTHHHTHHNNBNNNNHHNNNHTTTHT
NNHNTNNNHNNNBHNBTTNNHTHNNNNTTNNBNNNNBHNNBNNNTBNNNBNNNBNNTNTNBHNNTNNHNNNHHNHNHHNNNNTNNNHNNNTHHNTTNTNN
NNNNNTNNNNTNBNNNTNNHNHNHNTHNBNTNBHHNTHBBNNNNHHNTNHBHNTNNNNNNTNHHHHNTNNBHNNNTNHBNNTNNHHBNHNHHNNHBNNNH
NNNNHHNTHBNBNTBNNNTNHNTBNNBTHNNNNNTNNHNNHNNHNBTNTNHHNBHNTNTNNBBHTNTNNNTHHHNNNNNTHNTTHNTNNNTNNNTBHNHT
NNNNTTNNTNTTNNNHBNNNTTNTNHTHTHNHNNTTNHHTHHHBNTHNTBNTHTHTNTHNNTHBNTTTNBNNHNBNTNHNNNHNNBBHNNNBTNNHNBHT
HNNTNTNBHNTTNNTHHNNNNNBBBNHTNTNTTNNHHNNNHHNNHBNNNBNBHTNNHNHTNHTHNNHHNBNHHHNHTNNTNBTTHNNBHHBHNHNBNNNN
TNNNNBTBNHHBNNTNBBBBBNNHHTNNNTHHNNTNNTHNNTBNNTHNNBTNNNHNNNHTNHNNNNTNTNNNNNBBNHNNHNTHHNNNTNNHTHBNNBNN
NHTHNNHNTNNTNNNBHTNTNNBNBTNHTNBNBBNTNTHNHHBBNTBNBNHBTNHBNHBTBHTTTNNHNTTHHBNNNHHNHTBTNNTBNNNTTNNNNNHN
NNNTTNTBHNNNHBNNNNTTNNTTNNNTHNBBTHTHNBTHTTHTNNNNNNNNNTTBTHNNNTNHNNHNNBNBNNNHBHNHNBNNNNBNTNTHNHBNHHHN
NBNBBNHNNTNBBNNNHHNNBNNBHBNHNNBNTBNNNNTNTNNNNNHNHNHNTTTHHTHNTNTTTNTNNTTTNNBHNHNTNHNNNNBNTHNNTNNTNNTB
NTHNHTBNNNHTNNNTNHHNHTNNBNNNBNNTHNTNHNHNNNTTHNBNNHNTNHHNHNHNTNNTNHNHNNTBNNNTTNTNNNBHBNBNTNNHBBNHNHNN
NNTBNHNHBNTNNBNTNTTBHNNTHHTTHNTHNNHNBNNTTHBNNNNNHHBHNNBNNTTTNNNBHTNHBBNNNNTHHHHBHTNNHNHNNHNBHNTBHTNB
HNHHNTHBNNTNTNNHTBNHTNHBNNTNTNTNNNNBNTBNNHTNTNTNNNNTNHTNHTHNBTTTHNHNHTTNNTHTNTHNNTNNHTHNBHTTTNNTTNNN
HHTBNNNNNHHNBHHNBNNNBNNHHNNBNBHNTNHNTBHNNNTNNNNBHNNNHBNHNNTBTTHHNHTNNNHTNNHNBNNHNTBHBNNHHNBNBNHTNNNT
TNTNTBTNNTBNNTNNNNNBNNNNNNHBHNNBTNBNTHTHTNNHNHNTNNNNTNNBNTNTNHNNNNNBBTBNNTHTNTNHHBNTNBNTNNBTNNHTHNTN
NNBNHNTBHBBNTNNNTNNTHBNHNNTBNNHHNNBTNNHNHNNNBHBTHHHNNNNTNNNHTNNHNBNNNNHNHNHNTNTHTNNHHBNHHNTBNNNBNNNH
TBHNNTNNTBBNHNNNNNNHNNTNTNTNHNNNBTTNNNHNHHTBNNTNTTTHTNNNNNTTNTNNNNHNNTNTTHNHNTNNHNBTTNNTBNTNNBNHHHHN
HHTBNHTTTNNTNTBNBNNNBHHTNHNTBNNHNTNNNNNNNNNNNNNBNHNNBNBBBNTHBNHNHNNBHHNBNTHTTHHNNNHHNHTHNTTNNNNNNTNN
NTBNTTBNHHNTTTNNHNNNNNTTNNNTBNNNNTHHHHNHBNHNHNTNNTNTNNNHTNTTNTNBHNBNNNNNTHBNBNTTNNTHHNNNHNTHNNTNBHNT
NTHNHNHNHNNNHHNNHTNNNNHHNHTNNNNBTNNNNBHHNTTNNNNHHNHHTTNTNHTNNNNHNBNTBTNHBBNBTNTNNTNNNNNTBTTHTNTNNNHH
BTTHTTNHHHNNTNNNHNHTTHNHHNTHNNHHNNHNNNNNHNNNTNBNTHTHNNNNNHBNNBTNBHTTNNNHHNNHNNBNNNNNNNHNHNNNNNNHNBNN
BTTNTNNNNNTNNTTNNTTHHHTNBTNNHBTTTTNNHNBNNHHNNHBNHTHNTNNBNNHNNHNHNTNHBTNNBNBHTNNBNTBNTNTNBNNTBTNNTNNT
NNBNTNHNTTNNNNHNTTNTNNNTHNNNNNNTNNNNHBTNHNHTBTNHBTBHNHTTNNNTHBHTNHNHTBNNNTNTNTNNTTNTTNNBNTNTHNTBNNNN
HTNTNTNNNHNBNNNNTNNTHTBNHHNNHNNNNNNNNHNTTNTNTNNHNHNHNNHHTBNBHNTNNTNTNNNBNBNTHBNNTTNHNHNHTNHTNNNNNNNB
TNNHBNHTNNNNTBHNBHNTTNNTTNNTNNHHNNTNNNTTTBHHNNHNNTBNNTNHHHNHNHNHNNBHNHTNNNNNNHTBTNTHNTBNNNNNHHHBBHNN
THNNHHNBNHNTHHNTNNBHNNNNNHNNHNBTNHHNNHNNNNNNTNNNNNBNNTNNNTNNTHNNNHNBNNTBNNNTNBHNHTBNHBHNNTTHNNNTTTNN
NNHBHNHHBBBBNNTNNHNNNTTBNTNBTBTNTBNNNNHNBNNNNNTBHNHNTHNNTNTHTTNHHNNNHBTHNNTTTNHTTTNNHHTNTTNHNTNNTBNN
HNBNTHHNTBNHNTNTHNNNHNBHNNNHNNNNBNNNTHTNHNNHTTNHNNHNNNNNTNBHTHNTTTTHTNNNTNTTNBNTNHHNNNHNNNTNTNHBTHNN
THTNNHNNNNBBBNTTHHHHNHHNBHTNNTTTNHNNNNTNNNNTHNNNNNNNHTNBNHHNNTHNTNTTHNHNNNNNNHHBNTTNHNNNBNNHNHNHHBHN
NNHBTTBTHNNNTTNNNNNNTNTBNNNTHTHHHNTNNNBNNTNNNNTNHHNTTNTBHHNNHNNNTNNNNNNNTHBTNNNTHTNNHTHNNNNNHNTNTHBN
NNNBHNHNNBTNTBNTHNNTBNTHTNNNTNNNTHHHNNHTHNNNBBHNNNBNBNBNHNHNHTNNTTHHHNHTHHTNNHTHHNTTHNHTHHNNHBTBHNNN
TNHTTHNTNNNHHTTHNNNHTNNNHTNHNHNTNHBNHNHNNNNHHHHNNBTNHHHNHNNNBNHNNNNTTNNNTTBNTHNNNHTNHTNNHNTHTBNHHHBT
NNNTNTTHNNNBNNHTHNHHTHNHNNTNBHNNNHNTNNNNBNNNNNHNBBNNBBNHHHNTBTNNTHHTTNNHNHNHTNBNNHTHTNTNHHNHNBNBNNTN
NTNHHNTTNNNNHTBNHNNBNHNHNTNBHHTTHHNNNNHBTNNNNTBNTNHNTTHNNNNNNNNHHTNNHBNNNNNNNTNNHNNNTHBHHNNNTHHHTNNN
BTHNHNNTNNNNNNNTBHNNNNTTTBHNNNTNNHNHNHBTNNHBNHNTBNNNNNNNTHHNNNTNNNNHNNTNNNNNBNTHTNTBTNNNNHNTTNHBTTNB
TBHTBHTNTTNTNTTNTTTTHNTTNHTTNNNTTTNTNNNTNNTNNHHTTBHNNBNTHNNHTNNNTHNNHNHNTTNNNHNTNTNNTNHBTTTHTTBNNNBN
TNTNNHNNNTBNNTTHTNNHTTNBHNNNBHTNTNNHHNBNTTHBTTNNHNBHNBTNNNNNNHNHTNTTHNNBNTHNTHBTNNNTBBBTNBBHTNNNHHHH
HTTNNHNTNNHNTTTHBNTNTTNNHNNBNTNNNTTTNNNNTBHTTTHBNNNNNHTBNBHBTNNNTTNNNNTHHNBTNNNTNNNNNNNTTNHHBBHNTHNN
BNNNHNHNTBHNNTTTTNNTHNBNNTBNTNHNNHHHHNNNBNNBTTBNBNHNNBTNHNHBTHNTTTTTHNNNNNNNNNNNBNTNHTHTBNNTNNTNNNNT
TNTNBNNHTHNNBHNNNTBNTHTBNNNTNTTHHTBHTHTNNHTHBBNHNHBNHBHTHNHNNNNHNNBTHNTHBHTTNHNNNBNNNTHNTBBNHHNBNNNH
HTNNHNNNNHNNNNNHNNNNNTNNNNNTBNTHNBNHNTBNNNNNHNTBNNTTNNNNBTNNNTNHNTNTNBNNNTNTBNBHHHNBNTNNHNHNNNNNHTNT
NNNNNNHNNNTNNNNTTNNNHNNNNNTHNNHNBTTBNTBNTBHTNNNTHNNTNBTNTHNNNNNNNTNNNNTNBTHNHTTNNTNTNHNNNNTTTHNNNHTN
TNHNNNNHTNTNTBNNHNBBTTNNNHNNNBNTNTHBNTTNTHNTTTTNTNTHTTNNNNNHNNNNHNHHTBBNHNHNTNNNNTTNTNNHBNTTBBHTTNHH
TNNHBNNTTNBNBNNBBNTNHHNTHNNHNHHBHBHNNBNNTTHNNNBBNTNHHHBNTNNNTNNTBHTBTTNHNNHNHNNNHTTNTNBHNTBTNNNHHNNT
NTHNNNTHHNHHNNHHNNNNNBNNNNNTNNHNNHNNBBHNNNTNNBNTNHNNTTHTHNNNBNNTTNNTHBNTNTTHNNHHNNNNNHNTNNNNHNNNHNTN
NNHTHHBNNNNHTNBNHNNNTNBNNNNBTNTNNNHNHNHHHNTHTNHNNNTNTTNNTTNNHBNBHNBTHHTTNTHHNNHBTNNHNHHHBTNNNNNNTTNH
TNBNNNNTTBTHNBHNBNNHNNNNNBHNNNNNNNTBTNTTHHNHHNNHBHTTHTNNHTHTTHBNTNNHNTNBNTNNNNHTHTNNNNHHNHHNHHNTNNTN
HNNNNNNNNNHNTNNTNBTBTNTNTBTBNNBNNTNTNNHNTTBNNTNNHNNHNHHHNHNNNBHNNHHHNTTTHBNHTBTHNNHHHNNTNNNNTHNNNNNH
TBTTNTTHTBHNTNNNTBNTBHTBNHTTNHNNHNBNNNTNNNHNBNHTTNNHNTTTNTNTTNNNNNNNHTTTNNNBTNTNNNHNNBNBNNNNNHNHHHNB
NTNTNHHNNHNBNNBBNNHNTTNBBNHNNBTNHHNNNNTNHNTTHHTNHNHNHTHNHNNHHTNNNNNTNBNNNTNTNNTHBTTNTNHHTNNTNTTNHNNN
THBTNHNNNBTBBNTTHBTNNNTBNNNHHNNNNTBNNNNTNNNHNNNNBHNHNNNNBNBHNNTNNTHBHHNBTNNNNTHTTHTNBHNNTNNNTHTHNNNN
NNHTTTNHNNBTNHNBNNBNTBNHTNTNTHNBNHTNHHTNNHNBTNNBHNHNHNHNBNNNNNNNNTNNNNNHNBNTHTNNNNTNBNNNNTBNBNNHNNNT
TNHHNNTNHTTNNNNNHBNHNBNNHBHHNBNBTBNNNNBNNTNNHNHHNHNBNNTNNNNBNHTHNNBNNTNNBHHTNHNNTHTNHBHNHNTBTTTNBTNH
NTHNBTBNBNNHHTNNNTNTNNNBTNTNBHNHTNNBNHNNNHTHTTNNBNBTNNNNNNNBHNBNNHNTNBBNTNNHTNHNTHNNHBTTHNHNHNTHNHNN
