3121211211211010111322131223213131211121312212131133323310213310111202313313101223031121101211111311
2113332113001222331130133133232121131322101111211312131111121121121111102211333321101232131321213121
2111331113113012101232131302302222111112121111231111102111111311213232111111223311120013121113110013
1311220231100010111202011113210021211013231133121121102131113211212312312011112310101011010011211321
2232321131031031112101310111313101111221121103321111121121121211311221221121131103011112112301112203
1311131121121122312313210101111113112311131213312231123323312233221110201113110210101011131112121012
1313323211121313131011221312211131111133010013112321010101102211212032131213303122111001113113100232
2211331112211033133110333121231111111221123111313321111021213131112321310303211111010232111221231121
1111121112201111331132211103131110231333133111310133110111101123112311112310211323113111003111132112
1111123311112113113311112113312321111103111111233232113011312211221210112101020221112132331011113302
1230121112313131311313112111333113102011200111331321011013111112211202102313110110120113123130100113
3311113131112321331111112101001013201222120311213031111133130312313333111031110123300111112103112111
1111122012113332211113111331123101123212211322111311112210231321313012331213211111102113311122132321
1322012131222210011213111211210101121203111312211101112221311011131301123121111131113201332112310131
1103212212223211111231131113331131222312311321211123212310311201210131133222303012231100111231213112
2111213233101111011113311113020313132121201111221111313021222221200211311101112111211121331121223200
3321121332113311332110132311121311323313122311312133332321122232123320211221331121121121311130202113
1111211331113111213112332111310101120333222333133011121211311131111111230111121231311111311113031111
2110312133101111231311110211112101111132110111311321121230221031233132021201033231231333001011131211
2321330212321112210301231113211113203102131311101323211311333113111121211201021123110130110031013001
2310112211133311003112233013113103133310112121311202111122213111321121012123110010111113320313113320
0032313231233122111111111131212311111111311220010321312113121113220132202312321331101031112011111322
3101111130213020111033113311222112121111111321212113210213211121131312111232111101131111111212211332
2102321012131311311130311201332111231111032331222021102111132312211133222133131111301233311111322131
2131121102113121221121211111313311031111222113113012210211111131231121121112011113213123221111131221
1121012112301221111011131133110220221321111111111221131212103111313111121120213111110112101212113213
1131213313101111101313231112320122313101213302130331110021313111330132133330101231111002233222122211
2133013111122211111121321131331203121313221222311311310111010133111110103223201110113110011313311121
3131111112311101112331111113111012123113112121112121131133231221111132301133221131113123131110213121
2111011112312022213021301011001111011003123233113111011122123103111031111102120120310222111131101112
2331123312311332311113311312121201112011131133213003120211013013221311131111212102120330111011031113
3232111113312322111121111310131112120112101313011111323131023101122031313011301211210210133322113331
3310111111131010221011013322311311033121130113111101212123133123311211311121111113330321123111130011
1212231111333021311131013112210112021112132213213311211101211111111313031332211311202313321021123113
1010110121122122131313321001213231231332102113111221311113111121312303223101323111312113313011111321
2111102133111332332111310211113310213312321112031112111113101222331113113311301220331221101223311313
2031230121121221111122321122231111333201110213112321220211113310031020120311022113011212211111121101
3311132122111110131201112012030110211112333021023112032131220031011130001111111311201011110121111133
0211131012221313102232133031130223111113132113133101033102133113321021312131213033211122223321312133
3331212121102231232113111111110113132031321111221123111333323121311010112230113121311111211112310201
3111101112310331131101132213111011313012213312322311121113220031303321121113310131230131113212111131
1122113122301022321122210112112112100033110303111123123110102321113231112311321111231111311113121111
1311122312311111111123310101312322231121220130102111323111111002311112210313112111231111121110230211
3112101021321211103133211102111110113221210311131111311321232212311301111212222112123332112111212113
1311311333103313112111101113301211320300333022231301011131121031311311212031210011131111112203112210
1131211101113031311110231121110102123131223233121110313301112101132131231311121312311133311111301110
1122131220122213030112012131131131101133131111111111021111122123111122113112121131321112111133211313
2232331111130020012012113023122311130131113113213111232101301113111011111103103111222223111320331131
3320210312231312121101332130312131313120331113111121111200112133203212111311211121111313121111231311
1111300212311201030133231113201311333311121330232010231302122202113113302221133311122122133010313211
1231123301332311110111311310121132011111112011112122213012311211132131111333101210320113001101321333
1311311121311111231212103131211220111102211322122101213031111103011311212121311311111111132100311311
3331000332131111131111112113111112211113031111222111011112113211130123120130211012132311111021010133
1110220111101211112231111231331313211211123111231111322131123203011131322111130001123311111131221131
2111131000111202212113011112333023123323122110232123131131322231111120101311321211111121311332132233
1210110233113022331310121311112021110112321131111111221312033132023111132131131131110131102222311130
1211131131112113101211101121121311333101111110021131321133131203211310313131311011312111111112011101
3102132220133211122032311210112301122313102130123212301311021110111133111111022112312010311312111132
2031233111321310111332113111103213121231121111311110311211210133131313110301111211112203221213311011
1203203111112301121111131320332111301121301021321100322131010122212210332331231001222111131120121130
1211121112001113111211310121212121112132321121211231233312113011321311032123322003111102100011311131
1122210113213122131111211311213223112200111112020133033121131211132321230202233331211212133111111211
1021112111121121211130021131103201011111101211300113122123101012112031111012111012311203010023031321
3312211311111231122122231011112001231112223310321111111211311323331011121122131133323131221133111111
1001111011111111132101110322131301221323231021121312210313321121110311201321032131131131111133111222
1103103031121022223220311111322212011313233313112113122310111131222123311303131111112311132131312322
1130211111123220333110311011213211033121213213233101222211121212133230101313310231132321331112213311
1121110133123112131313311111333132111122021103233111133112111110111112113332122131213132211231110111
1121212111121111101311121321113122011211131320131303111111132111312010311111231021313010313113301120
1110210111321321112311101111012123101133331311321111131113211131122131121111131113313232133022213303
0220133111231032333111322123033233203213213133211111011100113130130101312213111312111133213101013010
0221112122101101113313211212231221113033312121121203120301021233111133201122201231011313033101111130
1200121011232211111120101121313102121111311311211233131231113112112113311103030131111121131131211321
1210111111111331011111122112110211213011211112113311123031121222021221331313033121110111121123113213
1111023301331200331202120122133222311121302011111233310323121001031222111123211111011302123323121313
3123112113101021111310332021101033321031332112103210011113232111321331111132233131021132113131213211
0221113211212332201131221112113133030102010220130111110332011223112311012223233222311223323112021013
0121231111221033122133212330301211210033312011321011322303011323111131113231012031211121112212311213
1111131120021312212131321112131112110321332231111112112213333102111112033011010323121312131301313311
1110121131133321313113213332211203021113210131013313111121111312111112111233231011211301110010132121
1111301313021111202132231313211211221311121333231211013121113311033132223333122011111312311121111121
1331110133113102013113223221321222101113213130101121112213111120000213331113111112131021111311330223
1020213200011121300113103322221211301121321101231311203112110010112221221232211311301101103212111110
1131113213023101003313312111101111111113131221111103331322111312101121010110212101312131301021011311
1112100301211211313111012211011111102311212212112111211331321201103111230112112111111203311311112233
3131222123131110331113113131311211132311321231131131221311111013201210111133123111333112211132230122
2111312323211013011103213113113223111120011111021310311112232132032012111313022211313313110311212231
2121122131131211212113332012332330112223213121121210301111111321121132310321131301103111111111312111
1211211121121101132211021231221313011131321111233011101311011123132110312131312313311231231211221112
1331212211311210012212212101231311010311110131111321111110201231131123311312113122211311131313311112
1122202211320213112101311100101131321111211331133131111121111311113121311213121011110101333200210123
3231211121210100132213313112112132033121121211223201100121131123022311111223011121131321313121111233
3321112121213131233111113213113123101122113212010311331012111323112012312113210313120311131112123313
3131313111132311032121212023211311333111110211221123211133321313312111131101210313111112113122311111
1312110021313031111202103113111231131232021311113111111331121231031000321022130121213121111111212131
1311123321110111111111301321212211131112131231133211122013112122121102110311201112211113011313111133
0302322311312111031111112110112112120111131113113133021111313033113122312113311312322121112201310112
0210131131231010132201110112211112233312313031212323113113322131131131132111213122031222111131022212
3121201222313211312113111211212001121021211132133113012221033012121033203223011111132321101312201323
2132132013332213111211133231233211031112111221331313311121112111111122133111112211222131133121031011
