NNNNNNBTTNHBNBBNNNNTNHTTHHHNNNHNTNHNNTBNNNNNNNHTNTNBHTBNTTBNHHHTHNNTBTNNHTBNNBNHHNHNNBHNHNNTHNNTNNHN
TNNBHTNTNNNTNNNTHHTNNBBNNNHNNNNHTNHTNHNBHHHHNTHNNHHNTBNHNBNNNHTNNNHNNNNBNNNHNNNHTHHNNHNHBNBNNHNHTNNN
NNNBHHNNTTNHNNNHTNTHNBHTTNNNNHNBBNNNHHNTHNNTNNNNNNHNHNTNNNNTTHNTNNBHNNTNHNHHHTNBTNHTNNNNBNNTNNNTNNNN
HHTNNBHNBNNHHNTNNNNNNNNBHNNBHNNTNNHTBNHTNHHTNNBHHHBNTNHHNNNHNNTBNBNNTNHNHNTTTBNNBHNNNTBNNNNBTTBHBNNN
NBNHHNNTNNNTTBTNNNNNHNNNHNTTNNNNBNNNNNTHNHNHTHNNNNNNNHBNNHNNNNNHHHNNHBHHTNNNNNTNNNNNNNHNHHBBNTNNNNTN
NTHNNNTNHHNNNHNHNNNNTHHHHHTHNNNHNNHNNTNNNNBHNTTHNHNNNHHNHTNTNNNNHTNTNNNTTHHTHTHNNBNHNNNNTNNBNTTHBNHH
TTNNHNTBTTTHHTHNNHTHNNNNTHHNBNNHNNNNNNNTTHHNBNTHTHBNTTTNNNNBHNHNNNNNHBNNNNHNHHHHNTBHTNNNNBHNNNNNHNNN
NNNHBNNBHHNNNHNNHNNNTHNNNHNNNNTNHNTNBTNTNBNHTBTHNNBTTHNNBNNNBBTNTTHNNTNNNNHNTHHNNTNNNNTHHBTHNNTTTNBB
NTBHNNNNNHNBHNBHNNNNTNTHHHNNNTBNNNBNHBNBBNNBTHNHHNTHNNHHTHNBNNNHNHNTNHBTTNNTNNNTNNHHNHNHTHNHHNHHNNTH
BNNTNTNNNBNNTHTNTTNNHTTNTNTTHNTNBNNNNBTNNTNNHTBTBTHTHNHNBBHTNBTHBTNNNNBNNTTHNNTNTNBTHNNBHNNHNNTNHHNN
NNBNNNNNHBNNNNNNNBNTNNHNNBHTTBNHNHNNNNHBHNNHTNNTNNNNNNTNNHTNNHHTNHNHHBNNBNHNBNTHNHHHNTHNHNNNNHHTBNTN
NNTBNHBTBHNHNTNNNTHNTHTBHNNNNTHNTBTNNTNTNHHBNHNNNBNNTHNNTBBNNNNNBNTNNNNNTHHNNBTBTBHNNHNHHNNHHNNBTBNT
TTNTHNNNNTNNHNNHNHNNNNNTNNHNBNTBNBNBTHHTNHBBHNNBNTNNNTHNHNHNNNNNNTNNBHTTNNHTHHTNNTHTNTNHTHTTHNHTHNBN
TTHNNNNNNNHNBNNNHNHBHNNNHNNTTNHBTTBTHNNHBNNBNTTNBHNTNNNNNBTTNNNNHNNNHNBHNBTTBTNHNNNHTNNHNHTTNHNNNHNN
NTNBTHTHNNNNBNNTNNNNNNNNTNNTNHNBNHNNHBHHHHNNNNNNBTHNNNNTHHNTNNTBNHNNTBBHNNTNTNHNNNHNNBNNNNNNNTBHNHNN
NNNNHNNHHTTNTNNHNHHNNTHTNNTNNNNNHNNTHHNNNHHNBBTBNNBNHNNNNBBNHTNTNBTBNHNHBNBTHHNHNBTNTHNTHNNNTHTBBNHT
NTBTNTTNHNNHNHNNBHBNHTNNNBTNTBNNNNTNBHTBNNHNHNHBTNTNHNHHNNNNNNTHNTTBNTTNNTNNTNTTNHNTNNNTNNNNHTHBHNNN
NNNNBNNHHNNTHNHNNNNHNNHHNTNNHHBNTTTHHHTNTTBTTTBTHNHTNTNNHHHTNNHNNTHTNTNNNNHTHHNNNNNNHNNBNNBHNNHNTTNH
NHNNNTHBHBNNNNTBTNNNTTNTHTNBNHNHNNHNTHNNNNBHNNBBHTHNTBTNTHNHTNNHTNBNHTNBTBHNNTNNNNNNTNNHHNNHNTNHNBNH
NTHNNBTNTTTNHNHNNBBHHTBTTHBNTHNTTNNNNNNTNNHTTNNHNHBBNNTHBNNBTHNBTTNHTTHNNNNNNHTBNNNNNBTNHNTNTNHBHTNN
THHHNTTNNTNHHNNNHNNBHNNHHNNNHNNNTNNNTNNHBNBHNTHTNNNTHNNHHHTHNNNNTBHNNTNBTHNBNBNNNHBNTNTNNNTNBNTNTBHH
NHTNNNTNTNTTTNNBNNTNNNTNNNTHNNTHTHNNHHHTNNNNTHNBBBTTNNHNNNNNNNBBNNTHHNNNNHTTHHNHTNNNTHHNBHNBHTNTNNNN
HNNHHHTBNTHHNNNNTBTNNNHNNNHNHHTHNHHTTHTTNHHHNHNBNNNHBTNNNNNNHNNHTNHNNNNNNTNTTHNTNHTTTNBNHTNHNNTNBBHT
NNNBNTNNHNHTHNHNTNNNHNNNTHNNHTHHNNHNBHHNHNNNNNNTNBBHTTBTHNNBNNNHBNHTHTHBNBTNNBNNTNNNTNNNTNTNNNBTHHBN
BNTNHHNHNTNTTNHNTTNNNHNBTNNNBBTTHTNTBBTTNNHNNNNNNTTTHBNNTBHNHNTHNHHNNHBHNNNTTNNNHTTHNNBNHNHHTHNBTHHN
TTTTBBNTTNBNNHBNNHBNNNHNTNBNBNNTTTHTNHHBNNTTNHBNTBHNBNNNNNNNNNNBHHNHHNNTNTNBBTNNNHNNNTNNNNBNNBHNTNTT
NNHHNHHNNHTTNTNHHTNNTNBHTHTTHNTNHNNNNNBNNNTHNNBNNTTHNHTTNTTNNNTTTNNHBNBNTHNHHBNHTHNNNNHTHTNTTBNNHBNH
NTNHHNHNHNNBTHNBHNNTHNTTNTNTNNNBNHTNTNNNHNHNNNNNTHBTNTTNNNHNBTNTBNNNBHNNNNHTNHBHNNTNNNNNNHNBNNTTHNNN
NHNHTNNTTNNNTBTHNNNNTNNTBNNHNTTNNNNNNHBHNTBTTBBNNTHBHHNTBBNNHTHHNNNTTHTNBNHNHHHNNNNNHNBBBTNTNHNNNNBN
NBNNNTTNBNNNHHNNHTNBTNBTNNHHNTNNTTHTHHHNTNHNTNNTNBNNBNNTBNNTNBNHNTNNHTHHNNNNNNNTNNNHBTHTHTNNTNBNTNNH
TTHTNNTNNNTHHHTNTTNNNTTHHHBNBHHBNNNNBTTNBBBNTNTNNHHNTTNHNTNNHTTHNTHNNNTBHHNHNHTTTBNHBHBNNNNBNHNTHTNH
TTBHNTTHNNNTNNBHNTHBNNNBTNBNNNNHBNNBNHBNTTNNTNNNNTHNNNNNNHNNTTHBNHNNHBBNNHNBHTTTBHNTHNNNNNNNTHNNBNNH
BHHHNNNHNBNNNTNTHHNTNTHNTHTNHNNTNTBNNNNNHNTNTBNNNNNNNBNNNNTBTTBHTTTNNHNNTTHNNBNHNNNNTHNBTNHNHNTNHNNH
TNNHNBNBHNHNNHNTHNHHHHNTNNNTNTHHTNHNNHTTNHNNNNBNNTNNBHNNTBBNHHNBNHNNNNTTNNNHNNNNNBNHHNNNHHNTTBTBNNHN
NTNNNTBNHNHNTNNNNNTNTBTHBHNBTHHTBNHHBHHBHBTBHNNNNNTNTNNNNNNTNBHNHNNNNTHNTHHNBNBNNNNBNNNHNNBBTNNHNTNN
NTTTHTNNHTNNNTNTTBHNNNTBNNHNHNNNHNHNNNTNNNHHNBBHTNNNHNNTNHHBTHNNTHTNNTNHTHNTTNBHHHNNTNNHBNNNTNHNNNHH
NNBHTBTNNNBHTNBNNHHHNBBNHTNNHNNNTNNTNNNHNBNNNTTHNNNHNNNTNNHNTNBBHTHTHNTNHNNNHTNBHNHBTNNBHTNNNHNNHNHB
TNTNNNHBTHTNHTNBHHNNTHNBNBHHBNBTNHHHTNNHNNNNNHBTNTNNNNTNHHNNNHNNNNNNNNHNTBNHNNNNNHHNHNHTBNHHTTBHHNHN
THNNTNTNTNNBHHHBNTHNBHNHNNHNNHNNNNBNNTTNBTNNNNBTHNBTHNHNTTHNNNNNNHHNNTHTNHHTNNNNHHBHNHNHHNHNHNNNNHHT
TTNNHTNNNNNNNNHBNNNHTNNNHTTNNNNNHHNNNNHNNBNNTNNNNBTTNBNHTNNNTNBNBNNNTNHNNHNNHNNNHNNTNTHBNHBTNHBTNBNN
NTTTHNNTNNHTBNNBTNNHTNBTHNNNNTNTNNNNNNTNNNNTNNHNNNHNHNBNNNNNNHBNNHNNHNTHNNHNTHNNNHHNNNNTNHTNHHNTNNHN
HTTBHNHNHHHNHHNNHBNBBNTTNTTHNNBNNHTHTHNNBNNNHBNTHHNTNTTNNNHHNNNBNHNNBNTBBHNBNNNNNNNHNBBNHTNNHHBNTNNB
TNNNBHNNTNNNNHTNNNBHNNNNBBNBNBNTNNTTBHNBNTNNNTNHTTHNHNNNBNHNHNBHNNHTNHNNHNTTNNTNBNNNNBNHTNTTNBNBTHHH
NTTHHHNHHNNNHNNNHTBNNHNBNHNNNNBHHBTNBHHNHNTNNHNNNBTTTTTNNHHNHHBNNNNNHHNBTNBTHNNTHNHNBBHTNBBNNTNNTHTH
NNNHNNBTNNNNNNBNNHTTHTNNTNNNHNNNNTNNHNHHNNTNNHNTNNNNNTNNNHHNTNTTNHNTNNNTHNNHNNNNHBNBTTNNNNTTBNBNNNTN
BNHNNNNNNBHNHNNNHHNNNTBNTNHTBBNTNTNTNHHTNNNTNNNNHNHNNNNHHNNNNHNNNHNHNNNNNNNHBHBNBTTBBNNHHNTNNNNTHTTN
HHHBNTBNNTNNHHTHNHNHHNNNTNHNTTHNNNNTTNNNHHTNNBTHHHTBNNNNNNHBTHNNNNTNTHHHBHTTNNNBNNNNHTTNHHNNTBNNNNTT
NTTTNNNBNHTNNNHHHNBNTTNHHTNNNNTHBNTBNNHHHBTNBNNNTBNTBNHBBNHNHTHNBHNNTHNNNNHTNNHNTHTTTNNNNHNNHNBHTNBN
HNTNNNTNNNBNNNHNTNNTNHTNTNNHTNNNBTBTBTNBNTTNNNNNHNNNNNHNHNNNNHBBNNBNHNTHNNNTBNNBBTBTNTBHNTNTTNTHNNNN
TNNHHNTHNNTNBTTNNNNNNTTNHTHNNHNBHBHNBHBHNBNTHHNNHBNBNNNBNHNNTHHNHTNNTNNHHHTHBNNNBHNNTNHNHHTTHNNHBHNT
NBHHHBNHNNNNNTHNTTNTBNBNHNNNNHHNTNHHTTNNTNNTNNNNBTHHNHHHNNHNNNNHBNNNNNHNTNHBNNBNHNTTNNNNNHNNNTNHNTNN
NTTHTTNHBTNNNNNNTHNHNHNNBHTNNNNHNBNNNNNTNNNNHHNNNNHTTTNTTHTNBNNTNTHNNTBTHHHTNNHNNNNNNNNNNNNBHTNNNNNN
NNHHHHTNNNBNBNNNTHNTHNNNHNNNTTNNHHTTTNNNNBNNNHNNNNNTNTBNBTBNNNNBBNTTTHNHNNHNNHNTTBNBNNTTNTTNNNNHTHTN
NNHNHTNNTNTNNNTTNTNNNNHTNNBNNBNNHBNNNTNNNNNNTBTNTNTHNHNNNBHNNTTHNHTNTNNHNBNNHHTNTTNNNNNNHTNNNHHHNNNN
NNTNTTTNNNNTTNHNBTNTTNNNHNBNTTHNBHHNNNHNTHNTBBNHNNHHNTNHNNTBNTNNNTTHBNNNTHNNHBNHHBNNNNNNTTNNBTNNTNNN
NBTNHTNNNTTNBBTNNTTTTNTTHNNNNTNTNNNTNTHNNNBNNNNNNTNNNBHTNNBNNTTTNTTBNHNNNNTTNNNNNNNHNNTHNTTNNTHTBBHT
NNNTNHNNBNNNNNTNHTNTHNNNNNTBNBHNBNHNHHNBTBNNTHNTNHNTTTNTNNNBTHNNTNHHBHBBHHNNNHTTNHHTNHTTBNNTHBHHHNNH
NHHNTHTNNNNTTNNNNHTHTTBNHNNNTTNTTTTHTNHTNHNHNTHTTNNTTNBBHTNHNNTHNBHNTHNTHNNTNBNHHHTTHTNNBTNNHBHNNTNN
HNNTNNNTNNTNHNNNNNNHHNNNNNNNTNTNNHNBHNTTBNHHHTHNNNNNNBTHNHNNTTTBTTNNHBNHNNNNNTBNBHTNBNNNBTNHNHTHHNHN
HNHHTNNNTNHNHBNNNNHNTNNNBNBNNNNNTTNNNNNNTNTNNNBNNTTHNTNTTTHNNNTTTTHNNHTTNNNNHHNNHNTBHTTNHTNNTHTNHTNB
HNHNNNBNBNNNHNNBBNNHHTNNHTBNNNNBNNHNNNNNNHNBBNNHHBHNHNBTTTNHNTTNNHTNBHTHNNNTNNTTTTNBNBHNHNNNNNNTHNTT
BNNNHHNNNHTHNNTNTHBNHHNNNNTNNNBTNNNTNHNTTBTNNTHNTNNBHHBNTNNNNNTNTNNNNNNNTBTNNNNHNHTHNHNBBTNNNTNNNNBH
NHNHNNTTBNNHHNTTNNTNBTHNNTNTNNNHNTNNTNNHHNBHNNNNHTNHNNNNHNBNHNNNTNNNNTHHHNNNTHHHBHTBNTHHNBNBNTHNTHNH
NNTNNHHHNNBNNTNNHHBNNNTNTHNTNHTTNBTTNHHTHTHHBNTTTHNTNNTTNHNNNNTNNNTNNHNNNNHBHTNTHNBBHNNNNNTNHBNTNNNH
NTNTNNNNNNHNNNTNNTTHNBNNNNHNTBBNNNNNHBHTBHHNBNNNTHNHNTNHNNTBNNTTNHNTNNTBBHNTHNTNTHTTNNNNNTHHNHHBNNHT
NNBNHNNNNHTNNHNNNNTBHNBHHNNNTNNHHNBTTNNHNTHTNNTNNHNNNHNHNNNHHNNHNNNNBTTNHNNNBNTNBTBNHHTTNTNNHHNNHNHT
BTNNBNNBNBBHBBNTHHNNNTHTNTTTNNHHNBHNNNNTNNNTTBHTTBTNBNHTNNNHHNNNNBNHHNNTTBTNHHHBNTNNTHNTNTBNNNNNTNTB
NBTNBNTBNNTNNNNNNNNBNBHTBNHHNBTNNNNNNNHNNTHNNNNHNHNNTNNNNBHNHNNHNHNHBTHNNNHNNBNNTNHNNNNTNHNHTHNNBNNN
NTNNNNTNNBNNNHNNHNNNNNTHNHTNHNNNHNBTTHTNNNTNNNTNNHNNNNNTNHHBNNNNHBBHTTTHNHBBNBNNNNNHNHNTHHNHTNNHTNTH
HNNTBNNTHNTBHBNNHHBNBTNBNHTNTNTNNNBNTTNNHNNNNNNBHHNHNNBNNNNNHNNBNNNHNTHBNHNTNHTTTTNNNBNNNTNTHNTTNNHN
BHHBNTHTHHBNNNHNNBTNNHHBHNBNNNHBBHHTNNNTHNNNNTTNNNHBNTNNHNNNNTNNNHNNNNNNNNNHHNNBTNNNBNTHNNNNTHNHTNNB
BTHNHTTBNTNTHHNTBNHNHNNNNNNHNTBTNTNTNNBNNNNNBTHTBTHBHTHNTHNNTTHNNHHBNTBNBNBHNTNNTNHBHBNNTHNHNNBNHHTB
NNNNNBNHNTHHTNTTBNHBNHNNTNNTNNHNBNBNNHNBTHNHHHTHBTNHNNNNNTHNNBNNNTNNNNNTNHNNNTTNBNNTTNBBBHNNHTTHHNNT
NBNNNHHNNNNBNNNBNTNNNBBTNTBNHHNBNNNHNBTNTHTTTNNNBNBNNHTTHNTNHTBTHTNNNTTNBNNTTHBTNNTHTNNNNNNNNBTNNNHN
NNBNNNNBNNHNHNHHNNHTNTHTNHTTNTNHBNTBNNNHNNHHHNHTHNHHTNNHNHTNNTNHNNNNHNNHBBNTNNHNTBHTTTNBNHBTNNHHTTNT
BNNNNNNNNHNTHNTNNBHNBHNNHNHHBNNNNBNTNNNNNNHHNNNNNHTNNBNHNNTNNNNNTNTHHNBNBNTNNHBTNTNNBNTNNNNBTTHHTNHT
TTNNNHHHBTNNTBHTNHBBNNTNNHNNNNBNNHHTNNTBNNTBBHNHBHTNNNNNBNHTHNHNHNHTNTTNNNNHNBNNHNBNTBHNHHNNNNTBNNHN
NNNHNBNNTNNTNNHHNHNNBNTHNNNNTNHHNHHNTHBHNNBNNHTHTTTTHTTNNNTTNTNTHTNHBNNTNNNNTHNBHBBHTHHBNTTHNNNNTNNH
NNNTNNTHTHTNTHTHTNTNHNNTTTNTHHNNBNNTBNNTNNTTNHNHHBNHHTBTNNNNNTNNNNTNNNHNNNHNNNTHTHHHNNTNBNHNTBHHNTNT
NNBNHNNNNHNTHBTNBNHNHHHTHHTTBNTBNHBTNBBNNNNHHTHHNTBNNHTNNBNTTNHHHNTNNHNNHNTNTNTNHNNTBNNNNHHBHBHTTNHN
HNNHNBBNBTNNNTNNNBHNNBNNHNNNNTNHNTNNNHBNTNHNTTTNNNBBTHNNNHBNNHNNTNHTNNNNNHNTTNBNTNHNTNHBNNHNTHNHNNTT
TBHHNHHNTTNTNTNBBNNTNHNHHNNTNNNTTTNTHNNTTNTTNNHTHBTTNNNTHNHNNBNHTHTHBNHNNBTTHNNNBNNHHBTNBNTTNTNTTHNH
HNNNNTBNNNHNTNHHNNNNHTTHTNBHNNNNNNNHNTNTBBNNNTNHTNHNNBTNNHNTNTHHHNNTNTBNNNTTNHHNTHBNHTNBHNNNTNTNNNNN
HNHNHNBBNHTHTHNTNNTNBHNNHHNTBNNNNBNTNTTNTBNNBNNHTTNNTNBNTNBNBNHTHNNTNNNTHNHHTTNHHHBBNTNNNHBBNNTNTHNB
NNNTNNNBTNTNBHHTNBNHNNHBTNHBHBNNHHNBTBHNTHTNNTTNHHNHNNNHNNBNNNTTNNNTNHHNBBTNTNNTTNNNNHNNNTNNNNBBNTNT
NNNNNNBTHNNNHNNNTNTNHNTTTHBNHNTNNNNTTTNNTHHNNTHNNTNNTNHNHHNHHNNHTTNHNHHNNNNNNBHNNHNNBNNNNNTNNNHNBNNN
NNNTHNHHNHHHTNNHBBTTNNTTTNNTTTNNNTNNNNHBNBNNNTTHBHNNHTHTTTNHNHBTTTHNNBNHTTNNNHNNHNBBHBNTHNNBTTNNTNNN
NNTTBHTTTNHNBNNNNNHTTNHNNTNHBNTNNHNHBHNNNNNTHNHNHTBBNNBTNBNHTBHNNTTTNHHNNHTNNNTNTBTNNBNNHBNBNNTHHTNT
NTTNTTTTNTNHNNNNHHNHNHBNBHHNTHNBHTNHTNNNHHNNNNNNTTTNBTNNNHNHNTNNHNHNHTNNBNHNNNHTHNNNNHTNHNNTNNNBNHTT
HBTNHBTNNNNHBNNHNNNNHNNNHNHTHNNNHHBNHNHHBNHNBNNNHTNNHBHNTTBNTNNNNNNNNBHBBTNNNBHNNHNNHNNHNTNNNHHNNTNN
NNNTNNNNNTNNNNBNTBHNTNTNBHNTHNHNHNTTNTNHNTBTNNNNTTNHNHTNBTBTNNHNTHNBNTTNNNNHNNTNHNTNHNTNNHNTTBNNHNNN
BHTTNNNHTNTBHNNNNNBNNHNNHNNBHNTTNNHBHNNHTHBTNNNNHNHNTHTHHNNBNNNNNBHNTBHBTNNBHNTNHNNNNNNNNTTNNNNNNNNT
HNHNBBHTNHNNHHNTNNBTNNNTNBTNNBNTBNBTNNNNNHHHBHNHTNTNHNNHHBHHHTNNNHHNNHTTBNNNBNTBNBNHBNBNNHNNBNBBTNTT
NNNTNNBNHNHNTTTNNNNHTTTNHBNBNNBNHBBNNTNNNNHNBNTHTNHHTTNBTTNNTNNBHNNBBBBBTTHNHBBTNNTNTNNNNNNNNNHNTNNT
NNNTBTNBNNHHHTNNHNBHNTBNNNTNBNTTNNHNNNTHTNBNNNNNNHHNHTHNBTNTHNTNTTBNNHNNTTNHBTBNBTBTNHNNTNTNNNNNNNNN
NHHNHNNTNNNTNTHTBTNHNTNNTTTHTNTHTNHHNTNHBNNNNNNBHNTNNNTHNNNHNNNBBNTNTNNNTNNTBHHNNNNNTTTNNNTTNNHNHHNN
NNNHHTNTNTNBNNNTNNNNTNNBHNNHTHBBTNTNNTHHNBNHNNNHNTNNBNTHNNNNNNTTNNNNBNBNNTHNTNNHNHNTTNNNNNHNTTNHNNHN
NTNNNTNBTNBTNHHHNNHTNBTHNBNTBNNBNTNNNNBBTTHHHNNNHNNNTHNHNHNHNHNTHNNHTNNHNBBNNTTNNHNTBNTTNBNNBNNBHHNN
NTHHHNTHTHHTBBNNTNHTNHBBNNBNTTNHNTNBNBTHNHTHTNHBNTNNNNHHNNNTTNTBBNHHTTTNHNNNNTNNNNHBNNBTTBHBNNHTTHNT
HTNHNNTNTTNNTNTTNHTNBNBHNTNBTTNNNHTNTNHBNHNNHHNTNNNHNNNTBNBTNNTNHTNNTNHNTBNTTNBNTNHNHHNNBNNNNHBNHNTH
