BNHNTTHNNNNNHNNNNNTTHHNNHTTNNNTNTHNTNNNTNNNNNNTHNNNNBNNNBTBNNNHTNNTHHNNTHBNHNNBHTHNNHBNHHHNNNNBTTTHT
BNNNNNTHTNBHNTNNNNHHNNHHHNNHHBNHHNHBHBHNHNNNNNTTHNNHTHNNNNBNNHTHNNNNTNNTNHNHTBHNHTNTHHBNNTNNHNTHHHNN
NBTNNTNNNHNHHNHHHNHBTTNNNNNNHTTBHTBNNNNHNNHNTNNNHBHHHNTNTNTNNNBNNNNNTNTNNTHTBNTHNNTTNBTNNBNTTNBNTNNN
NTTNHTTNNNBNHNTTNNTTNNNNTBNNHTTNNNHHNHHHBNNNTNHTNTHNHBNTNHNNNHTHNTHHNNNTHBTTTHNTNBNBNNNNHTNBNBNNNNNB
TNTTNTHNTHNNNTBHTHNHHNNNTNBHNNNNNNNTTNHNNTBNNBNNNHNNNBNBTNNNNHTBTTTHTNHNHTTBNNHNTNHTNNNNNBNTHNNNNBTN
HHNTNTNHNBNHTNNBTHBBTTNTHHNNNNNHNNBTNHNNBTNHHBNHNNHNNNTBNNNBBNHTHNTHNNBHNBTTTTHNNTNNNHNHNTHBBNNNNBNH
NTTNNBHTTHNTNBTNNHNBNNBNNNHHNNNBTBNTNHNHNNHNNTNNTTHHNNTTTNNNNNNHNNTNTTTTNNHNNHNTNNNTNBNHNTBTHTNBTNTN
NTNTNHNNTHNNNHTTNTNTTHHTBNNNHNTTNHNHBBHNHNTNHNNNNHBNNHHNNBTTNHTHTNNBNNNNBTHBBNHNBNHBNBBTNHNNHTNHNBNN
NTNTNBHNNNBTTHTNTNTNHBNNNNNNHTHBNTTNNNBHHNBHTTHNHNNBNNBHHBHNNHNHTBHNBTBNNBNNNNBNNHNHNNNNBNTHNHNTNBNT
TNHNNNNNNNNNNNTNNHNNHTNNHNHHTNHTTNNNNNBHNHNTNNBNNNNHHTNHNTBNNBNBTNHNHNHNNNNNNTNNNNNNNNBTNNTNNBTNNNNN
HHHTNHHBNNTHBNHNNNTHNNHHHNNNNTNNHNBNHTHNNTNHNHNBNHHHNNTTTNHNNTNHHNTBTTHBTTBNHHNHNHNHBBTTNNHTNTBHTTHN
NTNNTHNNNHNNNNNNNTTTBNNNNTHTHTNNHTNNNTNNHBBTNHHTBHHNNTNBNNNNNNNNNNBNTHHBHNHTNBNBNNNNNNHHNHTNBNTTNNBN
NHHTBNNBNTHNNNHNBBTNNNNNBNTNNHNNTBBBNHTHNNTNNHHNNNNNNBTHNNNTNTNNBNNHTTNTNNNTNNNNNTNHNNNBHTNTTNNNHTTH
TNNNBNTHTTHBTNNNHTHNNHNHHBNNNTNBNNTNHNHBHNNBNNTNHNNBHHNNTHNNNHTTTNNBHNBNTBNHTHNTNNHNNNNTNHNHTHTNBHBN
BBTNNHNBNTBNNNNTNBNHNNTBHNTNNTBBBNNHNNHNNNHTNNTTHNNNHBTNBNHNHNHNTHHNBBBNTHNHBNNNBNNNTHHNHHNNTNNNHHHN
TNNBTTTTBNNNNNNTHNHHTNNNHTNTHNHNNTTBNNNBNNBBTTBNHHNHNTNTHHNHTNHBNNTTNNTNBNNNTBNTTNNHNHNNNNNBTNNNNNNT
NNNTTTNTHNTNNTTBNTBHHTNTTNHHTHBHTHTNNNHHTHNNNNNHHNNNNNNNHBHNNBNHNNNNBBNNBTBNNTHNHBNNTNHTNNTNHBNTTHHN
BTBHHNNHHNNHNNNNNTHBNTHNTHHNTNNNNTNNNBNNTNHNNHNBHNNNHNNNNNNHNNBHNTHHTNNTHHNTTNTNTNBNNTNHHBNHHNNHNTTT
NBNNTHTHHTTNHNBTHHHTNTNNNTTNNNHTNBNNHNHNBNHHTNHTNHBNNTNHTBHNBNBHNTHBHNNNHNBNTBNNNNBHHTBTHNHHNNTHHHNN
NHNNNTHBNTNNNHNBTTNHTBBNTNHNNTNBHHBBNTHTHTNNTNNTHNTNNNBHHNNNHHNNTNNNTNHHNHNHNHNNNNTHNTTTNNBBBNBNNTNN
NNNNNBHBNHNTHNNNTBHTBNTNHTHBNNNNHNTHTNTHHNNNNTHTHNBBNBTNNNNNNHNNBNNNHHNBNNTNHHNNNBNNHNTHNHNTBBHTTNHN
NNNNNNNHBBHHBBHHTNHBBNBNTBTNNNHTNHNHTNNNNHHHTNHHNTHTNNNHNTBNNTNNTHNNHTNHNNBNNNNNBNNNHBHHTNNNHNBNNTNN
TTTHTNNNNTBNHNHTHNTNHNBHNNTTNBTHBHHNNTNBNTHHTNNTHTTHNTTHTBHNTHNNHNNBNTTTNNTHNHTNBNHHNNNNTHNTBHHNNNTN
HNHBHNNNNBNHHBNNHHNHNNNHNHTBNBTNNNNNTNNHNTNTTNTHNTNNHHBNHHBNNNHTHNNNNNNTTNHTNTNBHNTBNNNNTNNTNHNNBTNN
THHNNBBNNNNNBHHTHNHTNHTNHNNNHTNNNBNHHHHNNHNHNTHBNNNNHTHNHNBTTHTNNNTNTNHHNBNTNNHNHTNNNTNTNTNNTNNNNNHN
NNBNNTHNBNTBTHHHTTNHNBTNNBBNNNTNTTTNTNTTNNNNNTNNTBNNHTTNNHNHTNNNBNHTBNHNHTHNTNNHHNTTNNNNNNHNNNBNTBTT
NNTNBHNHNTTHNTBHHHNBHNHHBNNNHNTNNNTNHTHNTTNBNTHNTTHTTHHNHTNTNNHTTNTHHNTTBNNHNNHNNNBNNBTBNNHNBHHHNNHB
NTTBHBTNNTNBBNTNTBNNNNBBNNTHNBNHTBHHNNNNHHNNNBNTHHTTNNHTTNNTTNNNBNNNNNNNHHNHBNNNHNNHNBBHTTNNNHNTNNNB
NHHBNNTNNHNNNNNNTHNNTTNNBHTNNTTNNNNNTTNNNTBNNBBNNTTTHHBTNTNHBHTBHNNHNTHNHHNTHBBHNHBNNTNNNNHBNHNTHNNB
NNNHNNNBTNNHHNNBTHHTNNNNNNNHNNNHNNNNTTNTBTNNNNNNNNTNHBBNNNNNNBNNTNNNNHHTTNNNNHHNHTNNNHHTNNTTNTNNHNNT
TTNHNHNTTNBNHNNNNHBNNNTNHNBNNNNTNBNNTNTHTNNNBNNBNNHTHBNNHTNNTHNTBHBNNHTHNNNNTTBNHNTNHNBNNHNHNNTTNTTN
NTHNNHHBBNNHNTHNNTNNNHHHNNHNTHTNTNHTNBTHNHHHHHHNHHNNHHNNBNNNNNNNNTNTHNTNNNNNTTNNTBBHHNNTTHHTHHNNHTNN
NHHHHNTHBNBNNNNNHNTNHNHNHHHHTHTNNNHNHTTHBNNNNNHTNHTTNHNBNNHTTTNHNNHNTNNBNHNTTBHNBHNNNTBNBNNNNNTNHNNN
THHHNHNHTHNBTNNTHTNBTNTHNNNTTTNTNNNHNNHBTTNTNHHTNNNNNNNNHNNTNNNNNNNNNNTHNHHNTNNNHHNBNNNHNHNHNNNNNNHH
NHNNNNHHNTNBBTHNTNHTBBNHNHHBTBNBBNHHNHNTNTTNTNHHNNNNNNTHNNHNHNTNTBBNNNBTHTNTNBNHNTNHBNHNNNBNTNNNNHBT
HHNNTTTBNBHNTBHNNTNNNNNHNNBBHHHTNNHTTNTHBTTNNNHNNHTTNHTNNNHBNNNNNTTBTNBHHNNNNBHNHHNNHNHNNTNNNNNBNNTN
NTNHHTNNHTNNNTHHHHNTTTBNNTNTHTNHNHNNNBNBNNTHTNNNNNHNHTHBBNNTNTNTNHNNTNNNTHNNTHNNNNTNNTBNBTTNNTBNTNNH
BNNHHBBBTHHNNHNNHNBNTNNNTHTBHNNTNNNNTBBNNNHHNTNHNNNNNNNNTNNNNHNNNNHTHNNHBTHHTBHNTHTHHHNHHNNNHNNNHBNN
NHNBTNTHNNNHTHNBTTHNBNBTNTHHNNTTTTHNNNHBNBHBBTTTNNTNNHNNNHNNNNHNNTTNNTTNBBTHNNHNHHNNHNHNTNNNHTTNBNNB
TNNBNTHNNNNNNHNNNNNNHNHHNNHNBBTTNTNHHNHNHBHTNBTNNTHNNNNNBBNNNTNNNNTTNNNNBBNHNNTHBTHHTNTNHNBBBTNBNTTN
TTHNTTHNTHBNNTTTBTHNNHTNNTTNNNNNTHHBHHNBHNNHNHNBHHHNTHNNBTNNNNTNNHBBNNNTNTHTHHNHBNHHNNNNHNTNNBNNTBTH
HNNTTNNNTHBNTNTTNTNNTNNTNNNNNNTHNNNNHTNNTTTNNHHNHHNHNNTNNHNNNNHNNNNNNBNNHNNHNNBNNTHNHNHTTHTHBHNNBNNT
NHBNHTNNHNBTHHHNBHNNNHBNNNHTHHNNTTNTTNTHNHHNHNNNNNHTNNTHTTTTTTHNNHNNHTNTHNTNBNNNNHNTNTNTNTHNNNNTHHNN
NNTNNNNTNTNNNNNTNNHHTHNNNNHTNTTNHNNNHTHNHBHHNNNNTBNTBHNHNHBNHHNTTNHNNNNTHHTNHNHNNNNNNNTHNTTNNHBNTNNB
NTNBTTHTTNNNBNNHNNBNNNHBTNHNTNNHBNNHTBNNNTNNNNBTNNHTHHNNHHNHNNBHNNNTNTNHTTBNHNTTTTBNNNNBHNNTHNHNNHBH
NNNNNTBNBNNHNNNTNNBHNNNTTBHHHNTHNTBBTNTBNTNNNTTTTNTNNNTNHBNNNNHBTHTTNNTBHBNNNHNNTHNHTHNTHBHHNTBNTTNN
HNTHHTNHNNTNHTTTNHTNNNNNTNNNHNBBNTHNTNBNNTNTNNNNTNNNHTHHNNBTNNNNBNNHNNNNNHNNNNTBNTTNBBNNHHNBNNTHNTTT
TTTNTTNBNTTNTNNHHNNBTHHNNBTNHHBHHHHTBTHTTNNNNHBTTTNNNNHNNNNNBTNHBBNHHHNNNBNTHTTNNNTHNTHNNNNTNNNNNBTT
BNNNTNHHTNHNTNTNNNHTHTBBNNTNNHTNNTNHTTHBNTNTTNNNNNNTNNNTHTNTNBHNHHNHTHHNBNHNTHNNTHNHNNNTTTHNNTTHNHHN
BTTTNHNHTNNHTTNNTHBTNNTNHHTBNTTNTNNHNTNNNHNNTNNTTTTNHNHNTHNTTNNBNTNNBNNHTNNNBTTNNBNHNNNBHNTNNHNNTHNH
NNBTNTNNNNTNNHHNBHTHNNNNBNHTHTHNHNNTNNNNHNTNNNBNNTNNHNNHNNNBBNTNNNTHTNHBTTNBNNNNNBNBHTNNTBNNNHTNNTHN
HBTNBNBNNHNNTNHNTTHNHNNNNBNTTTNNTTNNNTNTBBNHNNBTNHTNTTTNNHNTTNNNTNNTHHNBNHNNHTNTBTNNNTNTNNTTTNTNNNTB
HHNBTNNHTNNBNNTHTHHNNTBBNBTTNNNNTHNHBTTTTHTNTNNHTNHNTNBNTNTTTNHHNNBNNNNTHNHNNHNNNBNHTNNNNHHNNHNNNNTT
NTNHHBNNNTTTTTTTNTNNNNHTTBBNNNTHHHNTNNNHNNHTHBBTTNNNBNHHNNNNTTHHTNNHTNNTHNNHTNTNNNNNTHNTBNNTTNNTNHHN
NNHHTHNNNNHBHNNNNTNNTTTTTNNNNBNNNNHTNNNNTBNNTNTNNTNNTNNTTHNBHTBNTHTBNTHNTBTNHNTHNTTNHNHNNNNTHNNNHNTT
NHHNHTNNHTTNBNHHTNTTNHTNTNNNNNTNBTNHNNNNHNTTTNNNNNNBHNNTNHNNBTNNNNNHHTBNNTNHNNTNNNBTHNHHTNNNBBNNNNBH
NNNNBTNTNTHHTHBHBTTNNNNNNNHBNNHHNTNNNNTNNHTTNNNNNHTNNNHBBNNTNNBBNBBBHNNHNNNNNTNNTBTNNNHBHNNHNHTTTBHN
NTHBHTNNBHNTHNHNNHNNNHHNNNTNTTNBBNNTNNTNHNNBNHHNBNHHBNBNNNBNNNHTNNNNHNNHNNNHNHNNNHHNBHHBNNNNHTBNHNTH
HNTNHTNBTHNNNTHTBBNBHNTTBTTNNTTNBHNNTNNTNNNNTNNNNNNHNNTNTTBHTNHNNTNNNHTNNTNNNBHNNTNNTTTNBNNBNNHHNHTT
NHTTHNTNNHNTTTHBHNBNNNTTNTNNBNTTNNHHHHNNNTNTTHNTTTHHNNNNNHNTNNHTBNNNNHNHNBTBNHBNNHTHNTNBHNBNTBNTNHTB
NNTHTNNBNNNNNHTTHBNTHBTNTTNNNHNTTNNTNNNNNNHNNTTNHBHNHBNHNNNNTHTNTNNNHTNTNTBNTHHHNNNHNTTHNNTHTNNNBHNT
NHBBTHNHNBNTTHNNTNNNHNNBHHNHNNNNNNNBNHNNNTNHNNTTHBTBTHNNTTHNTTNNNNNHNNTTTNNNNNBHHNHHHNHBNNNHNNNNBHNN
TNTTNNBBNNNNNNNHTHNHBTTTNNNNNNNNHHHNNHHNTNBHTTTNHNBTTNNBHHTNNTNTNNBTNTNNNBTNTTHBNNTNNNTNNTBTBNHHNNBT
NTNHNNNTNNNHNNHBNNNTNTNNNTNTNNNNTHTNTNNTHNHTTNNNTHHNNNBHTNNBHNTTNTNHTNBNHNHNHTNNTTBHHNNTNTNNNNNNNHTN
TBHTTNHHHNTTBNNHTBNHNHBBNHHTNNTTNNBTNNTNTNNHBNHNHNHTHNHNHTNNHNNHHNNNNBTNBNHHNNBHBTBTNNNHTHBNTNNBNTTN
NNTNNTHTHHNTNNHNTNNNNHTHHNTNHNHHNNNNNNHNHNNTNNNNNHNNTNNNNNNNTNNTNBTTNNHBHNNNNTHHBTNNNNNNTHHTNTNNBNBN
BTHNNHNHNHNNNTNTNHNTTNBHHBNHBNNNNTTTHBNHBHNNNNNNNNNNHNNTNNHNTNTNBNNNNNNHNHNHHNHNBNNNTBNHNBNNNBTBNBTH
NNNNBNNTNHBTHHHNHNTNNNNNHNNNHBTTNHTNNTNNNTNHNHNTTTNTTBNTNHHHHNTNNTTBNNBNHTNNNNHBHNNNBHNNTTTTHNBTTBBT
NNNTTNTHHNTBNNNNHNNTNNTNTHHNBNNHTNTTNTNNNHHNNBNNHBNTBTNNHHBTNHHNNHBNHNNTBHHNHHTNNTTTTNHHTTNNNNNTTNNT
TTNNHTBHTNNTNNTHNHTNTTTNNNNNNNNHHNNHHHNNBNNHNHTHNNNNTHHNNNBTTNTHNNBHHNTNNTTNTTNNNNBNBNBHHHNNNTTHNNHH
NNTNNHHTNNHNNNNHTNNNNNTHNNTTNNHNNBTNHHNNNBHTNNHNHHBNNTTTHBTNTTNNTBHNHHTNNNNNNNNTNHNNNTNNNNNTHTHNHTTH
NNHNHNTBNNTBNHBTNTHNNHNNNBNHNNNNHNHHNTNTNNNHHBBNNNNHNNNNHHNNTNBHNBTNNBTNNNNNNNNHTNTTNNTNTNNNNHNNNHTN
TNNTNTHNHTNNHHNNHTNHTNTHHBNNHHNHHNTNNBTNTTHBNNNNNNBTTNBNTTNNTTNNNNNHNTHNTNBNHHNNHBNNNHNBHTNNNNTNTNBN
HNNTNTNNNNTTNTNNNHNTHNBNNBNBNNNTNNTHTNNTNTNNHBNNBNHHNNBNNTBHNHBNBHBTNNNHNNNNBNNNNHHNBHNNNNHHNNBNNNTN
TBTTNNTNTHNNNTBNNNTNNNHNHNTTHNBNHTNTTHHHTHBHNTHNNHTNHNNHTNNNHNNHNHTHBHHHNNTNNBBNNNTNTTNTTNHNNNNNNHTN
NHHHNTHNTNBNHNNBNNNNBTTNNNTNBHNNTNNNNHHTNHHNNNHHNNNNNNHNBTNNHHTNNNHNNHHNNTBTNBTBNNTNHNTBTNTHNTNHHHNN
NNNNNHTHNNNNHNTNHHNNBTNNHNTHBNNNNHNHNNNBHNHNHBNNNHNTHNNNTNHNNNNBTHTHHHNNNBNNNHHHNHNNTBBNHTTNHHTTTHTN
NTTNNNHTNNNNHNNHNNBHNTBTTNTNHNNTNHTNNNNTNHTTNHNHNHHNTNHNNHTNNNTHTNHNNNNNNNNHBNNTTTBNNNTTNHHBNNHNNTTN
NTNNHNNNNNTTHHNHHBNNNNBBHTTNTNHTTBBNNNTNNNNNHTTHTTTBHTBNNHTBTTTNNBNHNTTNTHHNTTNNHTHNNTTNHNNNHHNBTTNN
HBHNBHHNTNNHHTNTNNTNTTNBNBHBNNNNBNNHNTNNNBNNNTHBBNBBNNNHTHHNHNNTHTNTHNTHNNNTNNNNHNNNBNNHTBNTNBNBNHBT
TTTNNTNTNTNTTNBHBHHTNTNTNNHNNTBNTNNHTNNNHNNHNNBBNBNNNNNTNTTBHBNTNBNBNNNTNBBNBTNNNNHNTNNTNHHTNHBHNBNT
NNBHNHNNHNTHNNNHTNTNHTNNTNNNTBNNNHNHHNNBHNTNNNHHNNNHNBHNNHHNNHBNNNBNNHHBTHNNHNNTNNNHNNNTTNTNNHHNHTNH
NNHNNNNTNNNNHNNNHNNNTNNTHNHHNTNNTTNTTHNNTHTNNNNNNHHBTHHNNTNNTNNHTHHTNTHTTTNNNNHHHBBBNHTNHTNNNHHNTBNN
NHHTNHNBNHNTHNBNNHNTNNHHNHTNNNBHNNNNTBBNTHNBNNNNTBNNNNNNNBNNNNHNNHNBTTTNTNNHNNNNNBHBHHNNNHNHBTBTTNBN
NBNBNNNHBNNNNHTTNBNHNHHNHTNTNTTHHNNNNHTTNTNNNNHBBNTNNNTTTBHNTNBNHHHHHHBNNNHNTTHTNNHHNNHNHNNNHNNHNNBN
NNHNNHNNNNNHHNTNHNNNHNTBBHBNNHBNNNTTBTNTNNNNNNTTNTNNNTBNNHNNNNNTNNNNTNNNHNHHNHHTTTTNHNTNHHHNBNNNNNHN
HHHBNTTNHTHHNTBHNTNNHTBNNHNHBHNHHBTNBHNNNNNNNTBNNTNBHNBHNTHTBBNHBNNNBNTNTNTTNTHNNNNNNTBNHTNNNNNHNTNB
NTNNNTNHNHTTNTHHHBNNNHNNNNNTNTNNTNTNBNNNNHNTNNTHNHNHHNNTNNHHNNHTNNTHBHNHHTTNNNNTNHBHBNHNHHNNHNHNNNHT
NBNNTNNNHNBNHNHTBNHTTTTNTHHNNBTTTHHNTNNNNNHHTNBHTNTNTHNNNBNHNNNNNNNBNNBNHHNNBTBNTNNTTNTBTNHBHNNNNNNN
HNHHNHHNTNTNHTNBNNHHNTHTNHNNTHNTTNNTHNTTBTNHBTNNBNNNNNTHTNBNNNNNNBNNNNNNHNHNHBHBNHNHNHBTNTNHTHHHNNBN
NTHTNHNHNHNNNHHBBNNNHNNHNBNTNNNNNTNHNTNNNHHBHNBHHHHNNNHBNNNHNNNNNBNNHTNTNBNNNNNTNNNTNTHNHTTNNHTNTNNH
NHNNHTTNHHNBNBHBTNNHTTNNNTNNNNBBNNHBNNNBNNBNHNHNNTTBBNNNNNHTNNBNHNNHNHBNNBNNNNNNNNTTTTNHHNNTNNNNNTNT
NTTBHNTTNTTTTNNNHNHHNNNBTNNNHHNNHNBTNBNHNHNNBNNTHTHNHBNHHNNNNTHNNTNNTNTHNNHNBTNNHTTNNTTHNTBNNBNNNBBN
BHNNNTTTTBBNTNTHNNBTNNNTNHNNNNNNBBTHTNNTHNTHNHBNTNNNNTTNNNBTNNHBNNTHNNBNNHNNNNNTTBHHNHNNNHTNNNBNNBTT
NTTNNNNNHNBNNHBHHNTHNHBNHNNHNNHTNNHTNTHHNNHHNNNNHTHNBNNHNHHTHHNNTBNHBNNNNNNNNHHBNNNHHNTTHBNNHNTHTNNN
NNNBBNNHNNNHHTNHNNBHNNHTHNNBNNNHNNNNHHNTNNNNHNHNTHBHHNNNTHHNNNNTNBTNNBTNNHNNNHTNTHBNNNHBNHHNNNNHHBNN
NTTNTHNNBTNBNHBHNBTNNNNNHTNHNNHHNNNTNTTTHHHNHTTNNNHHNNNHNHNHNNNHNTNBHTHNTHNTNTHNNNHNHTNNNNNHNNNNNNNB
NNNNTNHTHNNHNNNNNNNNTNTTBNBNNNNNNNHHTTBNNHHNNNHNHHHHTNNTHTNNTNNHNNTNBNNTHNNTBHBHTNNTTNNNTNBNTBNHHNHN
TNTNNNNNHNTHNTNNHTHNBHNTNBNHHHNHNTHNTNTHTHBNHNBBBHHNNNBHBNNNNBTHHNNTBHNTNNHNNHHBHHNNNHHBNNHNNNTTBTNT
NNHTNNHHNTNNNTBNNNNBTTHNTBNNNTHBHNHNNNHTHBHTNNTTTHHNHNNTNTBNHHTHHTNBHNBTHTTTTHTNNNTNNTNNHNNTNNHNHNNN
