BHHBBNNNNNHHNNNTNBNTBHBTBTBNTHTBNNHTTNNTHBBNHNNTHHNTHNHBNBHBNNNHNHBNBHNHNHNHNNNTHHTHHHNNHNTNNNBNHTNN
TBNTTBTNNNBNNHNNNNNBBNHHHTTNHTTNHTNNNHBNTNNNNTHNTNNTNTTTTNNNHNNNBNBTHBHTTTNNTNHTHNNNNNNNNNNTNTNNHNNB
HTNNTTBNHNNHNHNHBNNNNNTTNTHHNTNNNHNNNNNHNBHNNNHNNHTNHHTNBNHBNHTNTBNNNNNNBNTTNHNNNNHTNTNNNHNNNTNTNHTH
NNHHTNNBNNNNNNNNHNNNHNTNNHHNHNTNNTNNNNBNNHTNNNNTTNTBNNNNNNNBHTNNHNBHTHTHNNNHNBNNHBBNHNNNHNHHNBTHNBNB
NHNNTBNNHTNHNNHNHNNNHNHNHNBBNNNNHHNNNNNTHNNNNNTNNNNTNBNHNNHTHNHTNNNNHTNHNNNTTNTNNBTBHHTNNNNNNNTTNNHT
NHNHHHNNNNHHNHHNTTHHHTHBNTTTTNNBBNNNTNHNBNHHNTNNHNNBNBNNHTBNHNHHNNNHTNNBHHNTHNNNNHNHNNTNNBTNTNHNHNTH
NNNHTHNNTTTNTNNHTNNNNTNNTNNHHNNNNBNNTNNTNHTNNNNTNNNTNNHNBTTNNTNHNTTHBHBNNBNNNNHNHHHTNHBTNNNNHTHNHNHN
NHHNBHNNBHHBNNHTTNNTHNNBHNTTNNNTHNHHBTNBHNTNTHNNBNNTBHNNNNNNTHNNTHNNNHNNNBHNNNNHNNHNNHNTTTNTHTNTNNBT
NHTHTBHNNNNNNTHTHNTBNNHNNHNTTBNHTNHTTHTNNNNTHNTNHTNNHTNNNBHHNHNNNNTNHNBNTNNHNNTTNNNTBHTHHTTNNNNNNTBN
HHBHNBTTNNNNHTNBHNTTHNTHNNHNBTNTNNNNHBNNNNNNNHTTHNNHHHHTBHTHNNHNNNNNNNNNNBNTNNTHNHTHTNNNNTHNHHNNNNTH
HHTTHBNHNHHHTNHBTHNHBNNNNTNHTNNHNTNHNTNTNHNNNHNNNNNNHNNNNTNBHNNHNNNHNHBBNHTNHHHNBTNTNTHHNNNHHHNTTHNN
HNNHNNHTHNNNBHNHTNHNTTNNNNNNTHHNNNHHTNNNHHNTNNHNBHNTNNNNBNNNHNNNNNBNNNNNBNNNNHHHHNHNNHBHTNTNNNTNHNHH
NNNNNHNTNNNBTNHNTNNHNHBTNTTNNTHHNNNBNNTNHBHNTTNNNBNHBHHNTHNNNNTBNTTNNNNTNNTNNBTNNTNHNNTNHTNNHTBNHNTN
BBTNHBHNHNHNNTNNNNNHTNTTTNNTHTHTNTNNNNHBNHTNTNHTTNNTNTNNNTNTNNNHNNBTNNBTNHHBTBTHHNNNNNNNNNNTNNNHHHHN
BNNTNHNHNNTNNNHNBTTTNTHNHNTNBNTNNTHNTTTTNHNNHNNTBNHTNHNBNNBNBNBNHBNTTNHNHNNNTNNNNTTBHNNTHHHNNNTHNBNN
NBTNNHTBNNNTNHNTNNNTNHNBNTHNNHNNBTNHNTHNNNNBNTTNNNTNNNTNBHNNHNTHNNTNNNHNHNHTNNNHNTTNHNNHNNTHNTTNBNBH
HNHHHHHNTHBNNNBNNTBTNNHNBHNNHNTNNTHNTNBNNBHNNNNTHBHTNTHHTHTNTTHHNNTNNNBNHTNNHNNBBBNNTNTHNHNNNHTNBTNH
BNBNNNTHHNTNNNNTNHHNNNNBHNBNNNNNTTHNHNNNTTBTNNTHTTBHHTBTTTTTNTNHNTNHTBNNTNTNTNNTNHNHHNNNNTTHHBBNNNNN
NTBTNHTTHBNTHTHNHNHNNNBNNBTTBTNBNTHNHTNNNHNHNTTHHNNNNTBNTNHNHNNTNTBNNNTBNNNTNBNNTHNNNNHTTNNNNNNBNNBN
NNNBHNNNNHNNNNTNTTBNNBHNHTNTHNTNHNNNNNNTNNHBNTTBTNTNNNNHBHNNBTHNNNNBHNNNTBBHNHTNNNNNHNHNNNNNNTTTNTNT
HTNTHNNNNNBHTNHNNBNTHBTNNTNHNNNBTNNNTBTBNNBHNTTNNTHTNNNHNTHNNHNNNNHTNNHNHNBNBTNHTTTBNNTNTHHNHTHBNNHT
NTNNNHHNNNNNNNNHHBNNHTHNNNNTTNNHTHTHNHTHBNHTNNHNTNHNNBTNNBHHHNNNNNBNNHHNTHBNNHNNNNNNNTHHTNNHHHTHTHNT
NHNNNBNHHHNTNBNHNBNHNNNNNTTHNBNNNBNNTNNHNNBHHNNNTNNNTNNHBHNNBNNNHNHHNHHNHNNNTNNNNHTNHNBNNHNBHNTHBHNT
NNNNTNNNNNNNNNNBTNNBNNNNNNNTNHNBHNHNTNNNNNTNNNHTTHNTNNHTHNBTNHNTBNNNHNNHNHHTNHNNTNNHBNNNNNBNBNTNTBTH
NNNBNHNHNHHTBBNBTNNNNNNNTTNHNNHHHTNHNBBNNBHNTNHBNNBNNNTNNNHNNHNNTNHNNNNNHNNTNTNNNHTNTBHNBHTNHBHNNTNT
NHNNNTHHHTTTNHTTTNBNHNNNTNNHTTNNNNNBBNTNNNTTNTNNTNHBHNTBBHBNHHTNNNTTHHTTTTNHTNNNNHTBTBHHNNHNHNHNTNNN
HNNNNNNNNTNNTTNTNHHTTNBBNBNNTNTHNNNTNBNTTNNTTNNTNHNNBTHNNNBTTNNHBHHBNHNNNTBNNTTNNHNNTNTHNTHNNTTHNNNB
BNBNTHTNBNBTHTHNTHNNNTNNNBHNNHTNHHNHHBTNHNTTNNNHNTNTNHNHTNHTNHBBNHHHTNTHTHNNNNHNHNHNNBNNHNNTHHNNNNNH
HHTHNHNTNTTHTNHBNTNNTNNTNNNNBNTNHBNNTTBBNNNBHHNNTNNHBHNTBNNHNHNNNNTNNNHNHHTNBTNTBNNNNHHNNNNNNBNNNNNN
NTHHHTHHBNNNNBHBTNHNNNHNBNBBNBHNNNHHNTNTBNNHNHNNNTNTNNNTHHTNBNNTNHNTNNHHHNTHTBNNNTHTNHHNTNHHNNHTNNNN
NHHTHBHTNTBNNNNTNHHNHNHNTHNNBHHNNTTTHNHNNBTNBTNNTTNTHNNNNNTNNBHTNTNTHNHNNHTBNTNNNHNNNTHNHNTHTHNNNHBT
NHNNHNNHTHNNNHNTNNNBNNNHTTNNHTHNNNTNNNHNNHBNNNTNTHNNTNBTHTNBNNTTNHTBNNTTHNHNHHNNHNHNTNTTTTBHHTNNNNTN
NNNNBHTNTNHHNNHTNTTNNTNNNNBHHNBBNHNNNTNNNHNNBHNNNNTBTNTBTHNNNTHHTNHNHHNNNTNHNNNBTTBBNNNNNHNNHHHTNTNN
HHNTNNNTBBNNNTBNNNBTHHTNBHTHTNHHBTNNNBTTNHNNTNHNBNBHTTHBTNTBTNNNNHNBTNTHTHBTTNNNHNHNHHHTNTHNNTBTNNHN
BTHNHHHTBHHNTNHNNNNTBBTHNHTNTNTNNNHBNBNNNHNNTNHTHBHNNNNNNTNNTNHTHNNNHNTTHBNHHNNBNBNTHNNHNNTBBNNTNNNH
HNNHHTHHTHTNNTNTHHTNHNBHTNNTNTNNNNNHHNTTNTNNNNNNNNNNNNBNHNHTHNNHBNNNNBNNTNNHNTNNNNNNNTNNHNNBNHBHNNNT
BHBBHBHTNBNNNHNTNNHHTNNTTTNNNTNHTNTNHTHHNNBHTTNHNNTTNNNTHBTHHHHNNTHHNTHHTNNBNNTNHNTNBBHNHHNNNNHNNNHN
BHNBHNBNNNHNHNNHHNHNTTTTTHNTNNNNNHHTTTHNBNNNNHBBHTHNTHBNNTTNTNNNNTNNHNTNTTBTHTNHTTNTNNTHNTTBTTNNNHBT
NNTNHHHTBNBNNNTTNTNNHNHNTNNNTHNNHTTBTBNHTNNNTTNBNNNBNNNNNNHNNTTNNHNTHBNTNHTHBNHHTBHNHNNNBNHNHHNHTBNB
NBHNHHNNNBNTTNNNNBBHTNNTTHNNNBNBNNNNNHNTTNTNNBNBTNTNTTTTHNHBTNTTTBNTNNNNHNHNHNNNNNTHNNNHNTBNNBBTNTBN
HNHNBNHTHNNNTHNHNTNBNHHNTTHTNNTHNTTTNNHNTNNHHHNNBNNNHNTNNNNNBNNNNNTNNTNHNBNNNNHNTNNNHNBNHBTNNNNNTNHH
TNHTTNNTNNBNNHHNNNHNNNBNNNTTTTNNBNNNNHNTNTTNNNBHTNTNNTNHNTNHBTHNTNNNNNNHTHBNNNTHTNHNHNHNNNNNTHTNNTTN
TNNTBTNNTHTHHBNNBNNNHHTNNBTNNNNNNNNNNNHNNTNNNHTNNHNTBHTNHNNNTNBBNTNNHNTHHHBBBNHNNHNHTNNNNNNNHNNNBNHN
TNNHNNNHHNBHHHHTHTBNNTHNHNHNHTNNBTNNNTBHHNTTHTNBHNHBHNNHNNNNNHNNBNTHNHTHHNBNTHNTNHNNNBNTNNHNHHTHNBNT
THNNTBTHHNNNNHHHNNNNNNHNNNNHHHNHHTHBHBNBNNNNHNTHNTBNBHHNBNTTTNBHNNTTNNTHNNNNBTNBNHTNBNNNNNNNHHHNBHHN
TNTHNNHTNNNBNNNTBNHNHHTNHNHNNNBTBTHBBTHNBHTNHHHNNTNBNBNNBHNNNNHNNNNBNTNNNNTTHHTNNBNHBNHHNNNTNNTNNTHH
THNNHNNNTNNNHTHTNNNNBHNNHBTHBNTTBNTTNNNNTNNNHHNHBNNBNTBHBHTNTNHNNBHNTBTHNNNHNHNHTNNNNNTNNNNNNNNHHNHB
NTTBNHTBTNHNHBHTNNNTNTHTNNNTNNHTNTNNNBNTTTNNNNBNTNNBHTTTBNHHTBNTTNHNTTHTTTNNNNNHTNNTTNTHBNNNHNTHHNNT
THNBNNHTHNNNNNNNNNTTNNNHNNNNNHTHHHNBNNTTNTBNNTNNNNNNNNNNBHBNBNNHNTHNHHNNBTNTNHNTNNTHNNHHTBNBNBTNNTTH
NTTHHNHNNNBNTNNNNHNNNNHTNNTTHHTNNNNNNNNHNNTNNTNBHNNNHTNNBNHHHBNTNHTNHNHNTNTNNNHNTNNTNNTNNNNNNBNNNNTN
NNNNTHBNHNTBHBTNTTTHNNHHNNHHNTHHNBTNHNTNNBNBBNNBHHHHNTNNNNNNNNNBHNNTNNNNNNTHNBTTNBHNHHTBNNNNBNTNNHHN
NNTNTBNNBNNNHTHNHTNHHTTBNBNBNNNNHNTNNNTNNBBNHTNNNTNTTNHBNTHHHNNHNNNHNNNHNBNTHNNBHTTHHNNHTTTHTNNBTNTN
NNNNHHNNTBBBTHHNNNTNNHNHNNNTNBHNNNNNHNTNTBNHTHNHHHNNBTNNNNTNBTNTNNHNNBTHBBNTHHHNHNNNNTNHNNNNHHNNHBHT
NTNHNNTNNTBBBNNTNNHNNHHNNNNNTHNNHHTNBBNHHTBNHBNHTTNTNNBNTNNHNNTNHHNTNNNNNNNNHNHNNTTNHTNHNHTNTTTTNTTN
NHNNNNTNTNNBNHBTNNNNBTTHNNHTTHNNNTNNNNHNHTNNNNNTHHHBTNHNNNHNBTNNNTHHBNBNNTNNNNNNTBNNHNHNNHNHTNHNTTNT
NHNBTBNHNHTNHHNHNNNNHTNHTBHNTTTNNHBNNTNHHHHNNNNNNNNBBNNBBNTBNNNBHNNBBNBNTNTNBTTHHTNNTNNNNHNNNNTTHNTN
NNNNHHNNHBNNNNNNTHTBHTTTHNTHNTHNNNNTTNNNNTNNNHBNBHNNNHHNNTHNNHBHNNTNTNTHNHNNBHNNNNTTHBNHBHHBBBHHHNHN
TTTHBNTHBHNNHHNNBNNNNHHNHNNHBHNBNBNHNNTNHHHNHNNNTTNTNNNNNNNHNHNTNHNTHNNTNTBHNHNBNBNHNNHBHTNHNHHNNNNN
BNTTNNNNBNHNNNNNTNBBNNTHTNTHBNHBNTNBNNNNNTTNNHHNNHBNTNNNBNHHHNNNNNNNNHNNBNTHNHHTTNBHNHTTTNHNTNNNNTNN
HNHNNNTNNHNNNNNHNNNTNBNTNNNTBNNNNNBNHTNNTNHNNNNTBTHTNHNBNNHTHTHHHBHNNHNNHHNHHNHTNNHHTNNTHNTNNHTHTNHT
NHHTTNHNNBNTHNNNNNNNBHHHTNHNNNNNBNNNBTNTTNTNNNNHNNTHNHNNHNHNTNNHNTNHTNNNTHNHTNNHTHHHTHNNTNNHTBNTNTNN
NNTBHBNTNTNTNBHNNNNNHTNNTHTNNBHNNTBBHHHTNHTNNTHNTNNNNNTNTTHHNNNNHNNHHNTNNTNNNNHNNNNHNHTTNBBHHTNNNNNN
NNTNNNNTTNNNHNTTHTHNNNNHNHBTNNNBNNNNNBNTHNHNNNTNNTNNHHNTHHBNNNNNNNTTHNNNHTNNNNNNHNNHTNNNNNNTHTNNBNNN
NTNNTHHBNNNHTTHNNNNNNNTHNNNTTHNHHNTHNHNNHNTNNHNNNNHNBHNNTTHNBTHNNHTNHTHTNNBBNNHBTNBNNHTTTTNHHTNTHTNN
HNNNTNTHNHNNNHTNNNNBTNNTHTTHHTTNHHNHHTNNNHNNNHNBNNTHNBNHHTNHHNNNTNHNNNNTHNTBNTTNTHTHNTBHHBBNHHBNNHNT
NNNHBHNTBHHHNTHNNHHHNTHNNNBBTBNHNNHNNNNTTTNNHHBTNHNHTTHNNNNNTHTNTNNBBHNNBNTNTNNHNHTNNHNBNNNTNNNNBNNN
TNNTTNHNHNNNTNNNNNNNNTBNTBNNNNNNTNNTNTNNNNNNHTTNNNNTNNNBTTNHTNBHNNNNHNNTHBNHNNNTTTBNHNNNHNBBTHNHTTHH
HNNNNHTNTHNTTNNNTNNHNNNTNNHNNNNNNNNNNNNBTNTNNNNNTHHNNTNNHNHNHNHNBNNHTNHNNNHHNNTNNTHHNHNTNBNNNNHNTNTT
NHHBBHNNTHTHBNTNNTHNNTTTHBNTHHTTNNNNBNNTNNBBHBTHNTTTNHTTHHHNNNTNHNNNBNHNTNNHTNNNTBHTNNHBNNNNHNBBTBTT
HBTNNNNNNTBTNNTHHNTNNNNNNTHNNTTNNTNNNNTNNTNTNNNHBNBTNNHHTHHNHNHNTTNNHTNHNNNTNBTHHHHNHTBNNNNBTNHNNHNN
NHNBHHTNNHNNTNNNNNNHNNTBNTHNNNTHHTTBHNNNNTNTTTTTHNNNNTNBHNTHNNNTNNNNBHNTHNHBNHNTNNTNHNNHTHTHBNHNNNNB
NNTHHNNNHTBNNNTHBNNTNNBHNNNHNNNBNHTNNNNBNTTHHNNHHNHHNTBHBNHNTBTHTNNHNBTNNTNNHNTBHNTTTNNTTNNTNNNTNHTN
TNNNBBBHHTTNNBNTHTBNNNNNHNNNNNNNNNHNNHNBNNHNTNBNHTNNHNNNHBNNHHHHNNHNNTNNNHNNHHNHTNNBNNTNNTNBNNHTTTNN
NHTNNNNNHNNNBNNHNTTTHHNNNHTHNNBHTHHNNBHHNHHTNTNNNNNTNHNHNNHTNHNNTNHTBHNHNTTTTBTHHNTHHBNHNHNTNTHTBTTH
NNHTBNNNNHTTNBHHTNNNNTTNNBTNHNBNTHNTNNTNBHNNTTTHBTNNHTNNNHNTNBNNBTBTNNTNHTBHTHTHTHTTNHNTNHNNNNNTTNNN
NNNNNTNNNHHHNNHHHNNNNNTTNNNTBBTNTHTTNNTNTTNTNHTBNNNNNTNHNTNTTTTTNHNBNNTHNBNTTTNNNNHNNTTHBTBTTHTNBTNT
TNTTNBNNTTBNNHTNBNHNNNNBNNTNNNNNBHNNNTTNBHTNNTBNHHTHHNTNNBNNNNNNNHTHNTNHNNTNNTBBNTNBNNNNNTTNNTNNNNBN
HTTBTNTBNHNNNNBNBBHNBTTNNHNHTHHNHNTNHNNNNBNNBBNNTHHTHNNHTHHNBNBBNHNNTNHHTHNNHNNNNBHNTNHNHTBHTNHNBTNN
NNNNHTTNTTTTNNHNNTHTTTBNNNNTNNHNTNBNBTHHNNHHNHNNBTHNNTTNHTNNHHBNNTNNNHBHNNNNNNNHHBTHNHNNNHBTTNNNTTTN
NNHNNNTTNNHHHHNNNTTTHNNHHTNTBBTTTNHNTHTHHNNNHHNTTNNNNNNTTNTHNTNNNNNTHTHNHTHNHNHNNHHNNBHBTNTNHHHHTTNH
THTHNNNBNHTNNNTNNTNTNNTHNNNTHNTTNBTNNTNNNNHNTTTNNNHNNTNNHHNHNNBHTNHHTNHBBHNTNNBHBTHNNTNTNTNBNHHNHNNN
NNHNTNBTBTNNNHNNTTNBNNTNNNNHNNNNNTHNNTTNNTNBNNNTHNTTNNTNNHNHTHNTNNNHNNHNNHNHNNHHNNTNNNBNHNBNNTNHTTHN
NHBNTNNNNTNNNNHBHTNNNNHTNTNNNHNTBHTHNNTTTNHTTNNNHNNNHTHTTTHHHNNNNNTNNNTTNNNNTTNHTHNTBNHNNNTNTNNTTHNN
NNNNNTHHNNNNNNHNNNNNNNBNTHNHHNTTTHTNNNHTNNNHHHNTBNNTNNNHTHNHNHNNTNNBHHNBBBNNHTTNNNHNNHNTTHTTNNNHNHNN
NTNTNBHNNNNBNNTNTNNBTNNNHHNNNTNNNNTNTNNNTNNTNNTNHHBTTNNHTNNHNHNNNNNNHNHNNNNBNHNNNNTNBNNHNNNTNBTTHNNT
NHTNBHNTNNHNNNNTHNBNNNHNNHNTHBHBTTNNTNNBNHNHTNTNNNHNNNTHHNTTTHTNTBNHHNNTNNHNHNBTNNNNNTTBTNNNBNBNTHHT
TTHNNBHNNNBNHBHNNNHTNHNNNHTNTTNTBBNNNNTNNTTNNBBHTNBNTHHTNTNBNTTNTNHTNBBNNHNNNTHHTBNHNTTBNNNTBTNBBNNH
TTHBNHNNTHHBTNHNNTNNNNNNTHTTNNBNNBTNNNNNNBNTNNHBHTNNTTTHNNTNNNNHNNNNNNTNNNTHNNNNNNHHNTHTNNBTBBTHHHNT
NTNNTHNNNHHNTTNTTNNNNNNTTNTNNHNHTNTTNHNNNNTBTBHTNNNHTNNNTTHNNNBNNNNNHHTNNNNNTHHBNNNTNTHHNBTNNBHHBHHN
TTTBNHBTNNNTHNBTNNTBNNTBTNNNNNHNBNTHBNNHTTBHNNNNNNNNHHTBNHNNNTNNTTTBHTNNHNNNHNHTNTNNNNNHNBNTTNNNNBNH
NNNBBNNNBNNHNHNNNTHNNNHNHHNNNNBNNTNNTNNNNNTHTNNNTNNBNHHTNHNTTNNNNNBTNNNNNNNNHNNNHNNNTTHBNNNNTTNNNNNT
HNNNBTTBNHNTHBHNHNNNTHHBNNTNNNNBHBNTNHNTNTNTBHNNNHNBTNHNHHNBNNTNHBNHTTTHHTNTNTHNNNBHNTBNHHHNTNHHNNTT
BNBBNTNNBNBNTNTNBHNTBHTNTNNNBNNBBTNHHHNNTNHTNNNNHNHNBBTHTNTTHTNNHTNNNTHNNNBTHHNTBBTNHNNNNNHTNHNNHNNN
HNHNNTNNNNBNHHTBBHNNTTNTNHNNNNNNTHNNBHNTBHNHTNTTHTNNTBNHNHBNNNNNBNNNTTHNNHTHHNNHNHTNNTTNNNNNHNNTNTNB
NNHTNNBTHNHHNTHBNNNNHBNBNTTHNNNNNHNBNHTNNTNNTNNNNNBBNNTNBNNNNNTBNNBTNNHHTNNNNHHNHNNNNNNTNNNNNNNNNNNN
BBBNNNBNTHBNNTNNNTHHNHNHBBHHHHNTNNTTHNTNNNBNHNNNBNNNNNTNNTBNNTBHNHHNTTNNNHHHNHHNNNTNTTNNHNHNNTNNHNNB
NHHNTNNNHBNHTNHNNTHNNTNHNHBNTNNTNBTHNBTBNNBHTNHNNNBNNNNNNHTNNNNNNBNTBNNNNNHNTNNNNNNNNNHTNHHHHHHNNNHN
NNTHNHTNNBNNHNHNHNHBTNHTBNNNHNNHNNNNNHNNBNBHNNHHNNNNNTNNNHNHNTNTTTNHTBNNBBNHTNNTHTNBTNTTHTBTBHTNNHTB
NNBNTNBBHNHBNNTTNNHNNNHHTNHBNBNHHNNHNNNTNNHNNNTHNTNNNBNNBTNHNNBNHNTHBNTHNTNTNHHBHTBHTNTNNNHBNTHNNNNT
NNTHNNNBHNBNNHTNNNHNTBHNTTHNNNNNNNNNHNTNNTHBHNTBHTNNNTTNNNNBHNTHHNTTBNNNNNNNNNNTNNNNHHHHTNNNTNTNHNHT
