TBNNTBNNHTTNNTBNTNTTNNNNNHHBBNBNTBHBNBNTNTHNHNNNHHBTHTHNTNNHNTNNTNNNHNBTTNNTTNNNNNNTHTHHNTNTHNNTNTNB
TNNNNNNTTNNTNTHNHTHBHNNNTNNHNNNHNNNTHHTBHNHNHHTNNNNTNNTBHNTHHTNTNNNTTTNNHTNHHTNNTNNTNHNNNNNTNNNNNTHN
NHHHTNNBTBHNTNNTNHNNNTTTHNTNNTHNNTBNNTTHNNHTNTNTNTNNNTHNNNNNNNBNNNHBBBNHNBNHTNNHNNNBNNNNBNHTNNTHHNTH
TNNNHNNNTTBNTTHBNNNNHHTNNTTHTNTNHTNNTBHNNHNNNNHNTTHNNHNNHNHNNTTHNNBBHHNNHHTNHTTTBNNNNNNNNNTNHNHBTNBN
NHHTNNNTTNNNHNNTHHTNNNNNNNBNTHNNBNNNHNBHNTBHBHNNNHNNTNNTBNNNNBNNNNBTNHTNTNNTNNNNNHTNHHTNHNNHTHTHNTNH
THHTNTHHNTBNNTHNBHNHNNNHNTHHHTNBHNTNTTNNTNHTNNTNTTNHNNNNHHNHNNTBNNTTNNNNNHTNTTTNNTTNNNNTTNHTNNHBNHHH
NNNNHNTNNNBHHNTBNNNHTBNHNNNNTBNTNTTTHHNTNTNNNTNNNHNHHHNNNBNNBTHHNNHHHNHNBHBHHNBTNNNNHHNTHTNNNNNNHNTN
HNNNNTNNTNHNTBNNNHTTHTNTHNTNTNHTNTBTNNHHTHNNNTTNTNBNTHNNNTTNTNHNBNBBTNTNNHHNHTTNBNBHHTTTNBNTNNNHNNHT
NTTTTTNHTTHTTNNHNNNBNTNHBNNHHNTNBNNHHHHHNTHHNNBBNTNNNTNTNNNNBNTTBNHHNTNNHBBHHNNNNNTBHNNNNNNNTHNNTTTN
NBNNNNTHNHNNTBNNNNNNNNHNNBHNTTNNNNNTTNTBHNNTNTNTNNNNNNBHNNTHTHNHHHNNTTNNHNNBNNTNBHNNHBNHTNHTBNNNHTTN
TNTTTHTNNHHTNNNHBNTNNNHTNBNTNNTTHHTBNHNNNNNNNHNTTHHHTTNHNHHHHNNNNNNNTTHHNHNNNNNNHHNTHBTHNNBHNBBBHTNT
NNBNBNTHBNBTTNTTTBNNNNNTHNNNHNTTNNNTHNNNTNNHNTTHNTNNHHNBHNTBNNNNTHNNNNNBNTHBNHHHHBBHNTTTNNTNTNBHTBNN
NHHNHNNNTNBBTNNNTTTBNNTTNNHTBHNTTTTTHHHNNTTBTNNNTTTNNBNHNNTHNNHNHHTHNNNNTNBTHTHNHNHHNHNNTNHNTHBNBTHN
NNNHNTNBNNTTTNNNTTBTTNNBNTHBNBBHNTHNNNNHBNBNBNNNNTBNNBNHBNTHBNNNBBNNHNNNHTHNHNBTNBNTTTHTNNBNNBNBHNNB
TBNHNHBNNNNHNNNNBNBHHNTNTNHBNNHHHNTTNNBTNNNBNNNTNHHNTNBHNNTNHHTNNNHHNTTNNTNTHNHNNNTNHNHHNNNHNHNHBBNH
NNTTBNNTHNNNNHNNNHTNNNNTNNHBHTHNNNNNBHNHTTTTNTNHHTBHHHNNNNNTBTHBNNTNNTNNBNHTHNNTNBHTNHNHHTNHHNHNNNNN
NTTTNNHNNHNBBNHTNNNHHNBNNNNNNHNNTNTHTNHNNTHTNNNNNNTNHNNHNHHHNNBTBNNNHNNHNHBHBHBTNHTHTHNHNHNBTBTNNNNT
BHBHNHNNHNNBHNTNNNNTNTHTHBTNTBBNNTNHNNNNNNHNNNNNHHNHNHHBNHNNNNBNNBNNNNNNNNNHTNNNNNHTHBBNNBTHNHHBNNTN
NTHTBNHNHNBBBHTNNTTNNNNTNHNTTHBNHBHBBNNHBHTNTTNNTNBBTTNNNHNNNBBTNNHNNNBNNBHHNNNNTNHNNBNTNHNNTNHNNHNN
HTNNNNNHHTNTHHHHNTTTNTHNNNTTTNTNNNTTNHBTNHHBHHNTTNNTBNHHHTNNHNBNNNHNBHHHHBNNHNHHNNHTHNBTHHTBTHNHTTTT
HHNTNNNNNNTTNHNTNHNHTNHBNBTHHNTNTBTTBNNTNHNHNNHTBBHNNNHNNNNHHNNNBTNNHNBHNBTBTHNNNNNNTHNNHNTBNNTNNNNN
HNNTNNHTHNTHTNBNHHNBNNNHNHNNNNNTNTTHNNNTTNTNHNNHHNTHTNTNBHNBHNNNNHTNNBNNNTHNNTTNNBHNHNNNNBHNNHNNTTTH
THHTNHTHNNBHHNBHNNBNHNHNHTNHNNTBHHNNNNTHHNHNHBNNNNTHNHNHHNBTHNNNNNTHNNBNNNNBTNTTHNTHNNNNTNNNNHNTHNHN
BHNTNNBNNHNBTNHTNNNHBBBHNNNHBNHBHTNNTHTHBNNTNTBHBHNNNNNBNTTTNNNNTBTNTTNTBTHNNTNHNNBBNNHNNHBTTNNTNBHT
BNNTNHNTNHTBNHNNBTNNTHNNNNTBTNTBHHHNNNTNTHNNNHTTHNBNHNNHNNNNHNTHHNNNHHTTHNNBNTTNNHHNNTNHNHNNNNNBNNTN
NHTTNBNNTBNNHNNTTTNHNNNTNNNBNNBHNNNNNNTTNNTHHBHTNNNNHNNNTTHHNTHTNTNNHHHHNTHBNNTNTNTNHNNNBNNNNNHNBBTH
NNNTNNTNNHTTHBTNNNNNNTNNTTHHHTNNNTNNTNTHNNNTNTNHNNNHNBNNNHHTNNNTHHTBHNHHNTNNNTTTTNBNNNTTNHTNTNNHHNBB
TNNBTHTNNHNNTTHNHNNNBNTNNNHNTTNHHHHNTNBNTNNHTNHNHHNNNHHHHHTTNNHNNTNBNBNHNBHNNNNNNNHHTNNNNNNBNHBHTHHN
HTNHHTNNNNNNNBNHHHTHHHBTHNNTTNHNHNTNNBBHHNNNNNHNNNHBTTTNBBNNHNTTNHNHNHHBNTNNTHTNHNNNNBNNNHHTNNHHNNNN
NHNTBNTNNTTHTHHTNNNBNNHNTBNNHNHBNTNNNBNNNTTNTNHBHNHNTNBHHNNNTNTNNNNNNBHNNNBHHNNNHNNNNHNNNNNHTTNTNTNT
NTNNHNHNNBHNNTNNTNNTNHHNBHNNHBTHTHHTNNNNHNNNNNTTHHNTBHHTNNHNBHNBHNHNHBHNBNBNNBHNNNNHNHNHHTNHHNTHHBNB
NBHTNNNHHTHNHNNHHTNNHNHHBHHNTNBNHNNBNTNHHNTTNNTNNNNNHHBNNBNNNNNNNNNNTNTNHTTTHNBNNNNHTHNHHBBNTHHNNHNN
TNHTTNNTTNNBTNNNNNHBBNHHHNNHHBHNNNTNNNTNNHNTHHNTNNNTTTHNNTTTNBBHHTTTNNTHTNTNBTNNHHBHNTHHNNNNBBHNHNHT
NTNBTNNTTHNNNNHNNNNTTNNNBNHNNTNHTTTNTHTHBHHNBTNNNHTHNNBNNHNHBNNTNTNBNTNNNNNHBHNTHNHNTHNNNNBTTTTNNTHN
BBNNTNTNBTHHHHTNTNBTTNHNNBNNHNHTNTTNNTNHNNBTNNHTNTNNNTTHTNTNTTNBTHHTNBHHNTTHTNNNNTTHTHHHNTNNNTNTBNHT
NHTHNNNNNNNTHHNTNHNNTHTNTNTNNNHNNNTHNNTNBBHBNTHNHHHNNHNNBNNHHNTHNTNHNNHNNTNNHBNTNTHBTNTHNNNHTNHTNHTN
TBNNNTNTTNBNNHHHTBNTHNNTBNNTNHNHNNHNHTNNNTTBBTBNTNTNNNNTNTTTNBTNNNNNNNBNNHTHTNHNNNNNBNNNNNHTTTTTHNNT
NNNTTNNHNNNTNHBTNNTNNNNNHTHHTNNNHNBNNNNHNHTTNHNNHNHNBNBNTNTTNNNNBHBTTTHHBNHBTNNHBNNNNNNNHHNBNNBNTHTB
BBHNBNNNHNNHBHNTNNNNNTTNTNNNNHHNTNNNBTTTHBNNBTNTNNNNNNBNNNTTNHNBNNBBBNNNBBNHNNNNNHHBHNBNHNTBHNTTNNTN
NNHNNTNHNNNNNNNNNHNTBNNHNHTHNNNBTHTBTHBNNNBBNNNTHNNNNBNNHTNHBHNHNHTTBNNNTHNNHNNNNNNBNNTBHTNTNHNNNNTH
NTNBHNNBNNBHHNNTBNNHTNHTTNHHNTBNNNNTNHTHNNNHNNNBHTTTNNHBNNNHTNNNBTNTNNBTNNNHNTTNNTNTNTNBTNTHNTNNHNBN
BNNNNNNNNNBNNNNTNNNNNHNNNHNNHNNHHNNTNNNHTNNNNNBBTBNNNNNTNTHBNHHNTNTTTNNTHTTNHHNBTTHHBNTNNHNNTHNTTTNN
TTBNNNHTTNHNNNNNNHTNTTHNNHNNNTNTHTNNNTHHTNTTHNTNTBNNTNHTHTNTTNNNNBNNNNBBTTBNNHHNNNNTNNTNHBNBHBHTBHNN
NNTNNNNNHNTTHNNNHBBTHBNNNNHHBNNNBNBHBTTNHBTNTHNHNHNNTTHNNTTTNNNNNNNNNHHNTNTNHHNHTNNTHHNNTNHBNTNNNBNB
NTHNTTTNNNNBHNNTNTNTNTTNBNBNNNBTNNBNHHHNTHBNTNBNBHNHBBNNNTNNNNNTHBTTHHNHNNNNNHBTBNNHHHNNTBNNNBBNNNHN
BBNTTTNNNHTNNNNNNBNNNHTNBHNHNNNNTNHHNNHNNHTHHTNNBTHNNHHNHNHNNNNHHHNNTNNNBHNTNNNTNNBBNNNNNHNHBNNNBBNT
TNNTNNNHNNTNNTTNTHTTHHTNBHBNNNNNHNNTBNNNBNHNHNHBTNHNHHNHHTHNNNHHTHTNHTNNNHHNNBHTNNNNHTNNNTHHHNTHNNNN
NBNHTNTNNNTBTNNTNHTNNTHTBNHNHNNNNNHHNTTBHTHNNHNTHNHNNTTHTHNHNNNTHNNNBTNHNHNNNHNNHHTNBNTHNTTTTHHNNNHN
TNHBNNNTTTNTHNHNNBNHBTTHNHNNNHNNHHNNTTHNHHNNNBNBNHTNTHNNTHNNTNNTBTTHTBBNTNHNBNBNNNTHNNTNNNNNNNNNNNNN
NTNNHHNNTNHBTTHHHHTBTTNTHNBHNNNNTBNNNNNNHNHNBTHNTNHNBTNTTNHNTTHNBNTNBNTHNNBTHNTBNNBNTHNNHTNNHNTNTHBH
NHHTBNTNNTNNHHNNNBNHHNNNNNTNNNTNHTTNNNBNNHTNTTTNHNNHHNHHNTNNTNHNTHTNTNNTTHNHHHNHNHHHTTNBTNTNNTTNNNNT
HNNNTHTTNNNBHNNHNTNTTHNNNNNBTHHHNHTNTBNNNHNNBNNTHNHNHTHTNHBNNNNTNNNTNNTNBNNTNBBHTNTBHNHNBNNHNNNHTNTH
NNHNNNNNNNHNBBNNNTTNBHNNTHHBHTNNNNHNNNNBBBNHNNTNNBHNNTNHBBTBNTTNBNNHNNNNNBTNBNTHNBTNNNNNNTNNHNTTHHNT
HNNNHNNNNNNHTHNNHNNTNNNNNHHHNTNTNHNHTHBNTNTTNTHTNHNNHNHNTTNNNTHNTHHHHHNNNHNTBBNTNHTNNTTNHHTNTNTTNNHH
HBTTTNHNNNNHHTHNNBHNBBBNNBTHTHNTBNTNHTHTHHNTNNNTNTTHBNHNNNBNBNNTNNHNNNTNHNNNTHTHNNNNHNNTNNHTHNTNNNNN
NNNTNNNNNHTNNNNBBNBNTBNBHTTBHHNNNNNHBBNNTNTBHHTNNNHNHHHNHBBNTBNNNHBTTTNHTTHNNTHNNNHHNHNNHNHNNHTBTNTN
TNNNTNNTNTNNBNNTNNNTNTNBHTTTNNHTNNTNNNNNTTNNNHNNNNTNNNHHNNNTNHNNNTHHHTTNNHTHTNTHTHNNNNNNTHHNNNBTNHNB
THTNBNNNNTNNNTHTTNNNNHNNTNTNNNNNNTNNTNTNNTNNTHBBBNHHNHNHHHNNTTHNNNBNNTNHTTNNTTHNNNNBNTNTNNNNNNNHNHTN
TNNTNNNNNHNHHTNTNNTBHNHNHBTHBNNHTNTTNNHHBNNTTTNNNTNNTHNNNTNNHHNNNNNNBNNNNTTNNBHHHTNNNNNNNNBTHNNTTHBT
HNTTTHNBHHNTNNNTNTNNNTBNTTHTNBTTNNHTTTNNHBNBTTNNNNNNHNNHTTNNHNNNTBNNBNNNHTNNNNHHTNNHBHHNNTNNHTTHBTHB
NNNNNNTNHNNNNNTNTNNHTNNNNNNNHNBNTTNTTNNHNHTNNHHNHNHBBNBNNNNNNNNHNNTNNNNNBNNHTHTNHNTNNNNHNTNBHNNHBNNT
BNBBNNHHNNNTTHTHNNTNHNTHNBNHNTNNTNBNNTNHHTBHNNTHNBNTNBNBNTBNTBBHTHTNNTNNNBNTNNBNTHNTHNNNNTNNNNNHNNNN
NHNNNNNBBNBTNNTNNHNTNHNHTNNBNNNNNTNNNNNNTNTHNNNTNTHNHTNBHNNNBNNHNTNBNTNNNTNHNNNHNHNHHNNNNBNNHHNHTNHH
HNNTNTNHTNBNHTNNHHNNHTTHBNNHTTNHNHNNHHNHBNNNNHTNNNTNHNNBNNTNHNBNTTHTHHTTHTNHNNTNTTHHNBHTNNTTHNBNTTHN
NNNHTNNNNTNNHNTTNNTNNNNNNNHNTTHNBNNNNNNNNNNNTTHHNBHHNTNNBHTTNHBTHTNBNNBNHTNNTTNNNNNHNNNNTNNBHTNNNTHN
NHNNTNBNNNNNTNNHTNTTNNNHNHBNNTNNNNNNHHNNNHHNBHNTTTNHNTHHNTTTHHHHTTNNNNTNBNNHNNBTNNBBNBBNNNHNBNTHNNHH
NHNTHTNNHNHTNBNHNNNHTNTHHNHNHNNNHBTHTHNNNHNNTNTNTBNNHHNNHNNTHNBTTBBTHTNTTNNNNHBBNNBNNNHHNTNHNTNNBNNN
HNBNNTHHTTNHNHHNTNNNHTNHNHHBNNTBNTTNHNTNTTNNNNTNHTNNNNNNNHNBTTNNBBHNTHNNTHBTNNHNHBNNHNBHNNHTNNHTHNNN
HHNTNBNNTNTNHTNNNTNBNTTTNNHBTNBTBNHTNNHHHNTNNNHNNHNNNTHTNNNNTNNNHNBNTTNNHNNBHNTNNBHNNHNTNNNNNNTHTNNT
HNBBNNNNHTHNNNNNBTTBNTBTNTTNNTNNNTHNNNNNHTBNNBTTTTHHNTHNBTHHNNNNTNBBTNNHNNHNNNHHNTTHNNHHNNNBHNNTTNHN
NNNNTNNNBBTHBNBNHNBTNHNTBNBNNBNNNHNNBNNNTBNHHNBNNNTNHTNBNHBNTNBNTTTHNHNNTHNNTTNNHTHNNNTNNNTTNHBNNHNN
NNNHTTNNHHNNBNNNTTTNTNNTTNBNTBHNBNTBTNNNNNNHNNBHHHTNNNNNNNNTHHBTNNNTTNNNNNNNBNNNTTNHHHTTNHNHHTHBTNNT
NBNNNTNNNNHBNNNBNTBNNHTNNTNBNNNBNNNNHTNBTHNTNNNHHNNTHTTBTHNHNTNTTBHNHBHNNNHNBTNTNNNHBNHTNNHHNTNTNBTH
HNNBHNTNHHNNNTTHBNNNNTNHBTNNTNHBNNHBNTHHNTNNBNNNNTNNTHTHBBNHTBBNNHBTNBNNHHHNHHHHBHHBBNHNNTTHNNTTNNBN
HTNBTBNTNNHNHNHBNTTBNBNNHHNHNHNTNNNBHBNNNTNHHHTNNTNHBNBBNNTHTTTTBNNNHHHNNBNHHNHNHNBNTNTHNNNNTHTNTTHT
BNTHTNNNNNNHTNNNBHNNNTTNNBTNNHTNNHNTHNTNTNBNHHNNNHNNNTTHNTTBNNNNNNNHNTTNBNTHNNNTTNNHNNNNBNNNHHNNHBTH
NNNNTHNBTTTNNNBBNHNTBHHTNBNHHNNNTTNHNNBNHHNBNNNTTNNBTNNNNHNNHNTNHHNNTNNNBNNBNTNNNHHNNTNNNNNHBNTHBBBT
NNHHHNBBTTNTNNNNBNNTNHNNBNNNTNHBTTHBNTNNNNTNNTNTHNHBBBTTHTHTNHNHNNNNTTHNTHNBBNTHTNNNNHHNNBNNBHTTHHTT
HNNHTTNHBNTTTHHTTHNNNBNBNNNBTHTNNNNNNTNHNNHNNHNBNHHNTHTNTNTNBNNNHNNTTHHTNHNNHTNNNBHTHNNNNNNNNHHHBNTH
NHHHHTNBNNTNNBNBTTHHTNHBHNNTNTNNNHTNNNNNTNNBTNTNHNHTNNNHHHNBTNNTBNNNNNBTHNNNNNNHNHTNNNHNNNHHNBNHNNNN
NNTTTNHTNNNNTHNNNHNNTBBNNTTHHNNNNHNNNHHHNTNBNNHTNTTNHBNHBTNNNTNTNNHHNTNBHNNTNBNHNNNNNNHBTTHNTNNBNTTN
HTBNHNNNNHNHNNNHNBTNBHTHTBTHNTTNNNBNNHNTTNTNTTBNNTTHNNHBNBHNNTNTTHNNNNHBTHNNHBNBNNNBTTNHHNTNNTNNNNNN
BTTNNNTTTNTNTHTTBTNHHHTNNTNBHNTNNNNNHBTNTHTTTTTNHTTNNNNNNNTHHNTHNNTNTTNNHNNHTNTHHNHHBHBHNTNTNNBNTTTN
NNNNTNHNHNNNNHHHBHNTNNTNNNNBNHHBNHHNHHNNTHHNNTNTNTHTNHNNBHTHNHTBNNTNHNNHNHTHTTHNBBHNTNNNTBHHNTNNHNNT
NHBNNTHNHNNBNHBNNNNTNNHBNTHHNNNNNNBNNNNTNHBBHNNTNHNNTHNNBBNHHNHTNTHNTNNNTNHTNNTBNNNNBNNNHTNBNBTNHTTN
NNNHTHHNTTNNTNHNHTHNTNNNNNHNNNNBNNTNTNHTNHTNHNNTNTTNTNNHNNNHNHHTNNTTTTNNTHNTNHNNTNTTNNTNNBHHHTTNNHNT
NTNHNNNNTHNNNTHNTNHHTTHHNNNNHTNTTHHNNTTNNNNTBNBNNHNNTBBHNNBTNNNNNNTNNTBNTNNNBHNHTNHNTNTTNTTTHHNNNNNN
HNNNNTNNNBNNNTNNNTTNTNHNHNNNNNNTHHHNBTNTTHNNNNNNNNTTNHNTHHBNNNTNHNHTNHNNTBNHNNNHTBTNTTHNTNHTBNNNNNNT
NNNNHBBNNNTNHTTTNNNHNBTNNNHNHNNNNNTNTTNNTBBHNNNTBBTNHNNNNBNTNBNNNNTNNNHBNBBNNNNNNTNBTTNNNNNNHNNTBTNH
NHTNBHNNHHHNNHHNNNNHHNBNNTNNNNNNTNNNTNNHTNBBNNHTNNNHBNNTNHNNNHNTHNHNHTHNTNTNHNBHNHNTTTNNHHHNTNTNNBTN
HTBTNNNNTBNHTNBNNNNHNHNTHBBHTBBHHTTNNTTHHBNNTNTNBTTNNNHNNTNBHNTNNNNTTTNNTHTBBNNTTTNTNNHTBHNNTNHHTNNH
NNNNHNTNNHNNNNNNNTNHNNNHNHBHNNHNNHNNHTNTNNHNNNHNNBBHNNBNNNNHHNHBNNNNHNTBNTNNBNNNNNNTHNBNTNTHNTTHHNNN
NTNBHHNNHTNTTNNNHHTBNHTNTNNHNHHNNBNHNTHHHBHNTBNNNHTHHHNNHTTTNNNNNNNBHBTBTNTNTNNNTNNNNTNBNTTNNHNTTBBB
TBNNTNNNNNBNHNNNTNNNNHTNNNBBNNNNNNNHNTNNHTHNNNNNBNNNNHBHTTNHHNHNTNNHHTNNTNHNNNHNBHHNTNTNNHNNNHHNNNNN
HTHTNBNNHBBHHNNNBTTTNNNBNTNTNHHNHTNBNNNTTNNTHHTHBHHNTNBNNNTNHTTNNBTNTNBHNNNNBNNNNNNNNBNBNBTNNNNHNNTN
NTNBTHTBNBHBNBNHHNTNNNTBNNNTHTNHNNHNNTNNNNNNNBNNBBNNTTTBNTNHNNNHNNHTBNHNBBNNHNTTNNTTTNTBNNHNTBHNBNNN
TBNNHHTBNHHNHTNNTNNBNNTBHTNBNNNNTNNBNTBNNNNHNNTNTNHNNNTHNNTHTHNNTNNTNTNTNTHNBTNHNHNTBHNNNNNNNNBTHNBB
NNTNHNTHNNBTNHTHNTHBTTTNTNHNTNNNNNNNNHHNNNNNBTBBNNHTNHNNTBTNNNNNNNTHHBHNTNNTNTTNNNNHNHNNHNNNNNNNNBHT
NNHNNNNNTHNNBTNTHNNNNNTHTTNNNNNTNNTNNNHTTHBNTNBBNTBNNTHTHTTHNNHHTNNBNNNNTHNNHTNNNBBHHNTHHNNHNHBTHTHN
TNNTNTHNHNBTBTNBHNNNNTNNNTHHNNTNHNTNTNHNNHNTNNHHHNNNTNBNHBHNNHNNNNNBNTNNNNTNNBTHNBNNNTHNBNBTNTNNBTNH
