2113331321311313101121103213331202332121112213211301011312322321331122231131231113121313121212011132
1002131313201113311331132210101131031131112121333121231122111311121131103331011111311313231011113111
0213211112331212311020132311111030031103031311213110212332120213111330113111123031111131123111111011
0213221103221123111213213101113223111212312212202231113133111111002312301231313312211021322101121113
1212111331312112312310011311121312212121301113101332113101122230301110101311203322103111111132212112
1300111311110133131120112331332111312111131211021230011111331311203112211221311133131111131103201110
0133131120011131131211310211102303110111011122223201112321231313032330111102121101033033132211312212
3131101311321331302102122121113333111111313312013123221111121131112223121120312011111311111112121111
3113111311210131113111111212112211012321122111201322113111130101111111110233122111110311132111323113
2311101113113113031113112121210213211100111013113221011131311311203311333121131111111122211101111113
3320110130021021131133110111321113131021001323111110031111120211231121212332201130011102113133111312
1202010111111311120132311332113111311311131310131221131131113113210310121221111311112211231133311212
1013032221133122111223302211110012112030001121322021020111111112011332131323112122132121311101313032
1002311123113001121211311110022111131003112032112121121233131111211200111221331311213101112311201111
2011311123121211133111221312233233231221120123113112331212113003123113113111131311332210313211132031
3201321111211103231120231111312111311102302121232022310232321310311111311311111121111211113111131121
1223112102331312211112133011211111112231111210111221310210112101111322221233331311313012021313211310
2122310113111313132223113011033302132111332233311100211111112211303222011232111111101311321111103130
1131212311013021112133111011223131111211112122113013101111232012121232221311211310101131333312111331
3111111321031312013333113112111111211230011331023311101113121311321101013131123110312113212133113111
1110213021101111111121010131213011201120313033233211210112013232111113112310130111132131102121121012
2123312111103111131211131121110113321331133111110111113330113211213201113310231111111111203112133311
0111113310111211121331033113012211110010111113111121223232111113122122321110013121113012311211200101
2323330111133221113311112111313210322100302303233232122321123313003312211020101113132121133311112323
1311131210311310331211113101232101111303211322131212321011111112123102210222111311312111011110110111
0121132200303111133111211122113011133211112123113211102213131211113121111003121233311101111111111311
0031212201311331131302120111031313123310110121321211111111110121120111023200312110101112102220333131
2111111111213112131131310011211221323131213111110111122110311213111121312321131332203121031101221113
1111223113311311130311112112112212311111312011212221132123121133333311211112112111011201001323111302
1211112321311121113132113312213131231231211212121312003121311212111201011311111312212111321131312313
0103112111211111301131131111111113113201312111013133131122021111011223200311111101111123131331313312
3211112311023113311100112033111321022011111111311333011130213301122220131011122321311121232233133211
1111212122211111111331232132311131121120103112110301002313210110133133112121301110130111201132303131
3110332011112113232131333233101101013112111301330121011111203230111313123232100113111312021103111230
1111011131031211313312310312123111232311221012201211321311301212110210130111313231111211213231110011
1121331100213311113303321111221311201131131011121310331101313113323221111311311312101322221101301111
3112112312111310131101301113121111231101130130211133313233111011011211111103011113220231110213111100
2121202011111102312210213103221111111111211231121131121331021113111313211001133111122301311221111301
1101101121121132021311123110111111023021203323111212123010131131113132111231211101211111231111111110
1131113011310311131131311113333113113311112221231311213311111111333113313311311111012123112222101313
2230111113111102311121333331332311002312321323323221011322122013111123232121131113120131321312221013
1113112013213111200131331111223132313111133121133101011332110113111311120313302212003301312111111212
1212113111210333111110111300313110111132112111333211332323021021131122010011111123321001333221122110
2111132010111133111133122111311203113133311103123313312311313213113111321232323210111221131221311113
2221311023202111310231133113113131131111100132231111201120211113111131332130122221110302113133211311
1101133321113131130111111332133122131131212221213112121211301330333311101121112113301133113101133013
3112111020213231330111133110212122112213011110212111311231201111303212013112303313112132121331110131
0323333111213112021321311221113112110021113013211112201112111100112023112102111211211311011132112113
0332311122013122111023103013211121012131131212111011121132112213112223110323333213331112113211111113
1212313211130311101221221021111301222101121103131111221002211113010321123312121311111131110101113100
0311312121032332122331322221132221133013312111331111212011112031301121111113112113222112223110311232
1202131203131111113222110211332312131201312311111110021133131111111111112232202111311111132331331011
3111212113311210111131020201311212231112031123121231123213332111210121211321123332132311111303121132
3221102323112111102111111211331212112301112211212112123321211331121111321131133113031310120113112111
1212212023231301111230101111120110011230131311011111122111122013031311102112111131112111121132231102
1333312111331121131111132033131121211111133311111312301131111113311112211121331111122311121221301311
1203213113110030133131231323212111131221101331212121303123021232123221013111113211223223311111201113
1033111311121010121111121130121231121131222331031311332122122033210211312121323022112111121021132311
1331131311111122310230013113101112121111112110131310111111011223321213312122112310112131101231021121
2231311212310323213032030011312221112021112120311121012112113311221311211322112011312012213112121211
1121112132331111322111231031311002311131113101211311201223231011213211112110111132111123221121111123
2320123133012211111132023311323303232020112212111212332021112233311013221323211133102113113121321332
1113121132011002113201111121121213211132311110011213032110131131211132132122111203211311311130110131
0111313112121131111331011032321101101213311011110313311111113103122121131120121110211121111201111312
2231330130111132112111133131120301321001232231111121111110111111113311001101333110111221101012211032
1012311110322111130121123313023111301231131133133311103112113321321122013113311211111112111313330131
1232132011212312131101111231131123233023130111110112211111323101131202111021102112113123101211021111
0022111212111333213020113301133130021231011202131203321213111120220022012200112221330321110301113211
3213211112133101210313221111112111333122133331103111101131113201231110321331111212111110322310220133
2111013112121112032123220221112111112111111132212131123103122211213011312310121131111231130311211111
2103311331111321331320313231221310212233113111311120203222331032121031131112331223331312103321111300
2111101111201313113123301111111112101123021123313021101113221212113311102331103130311001311132212131
3122222113211210330123102303122123131131103111111300112331011313113321211310312122333011303111113132
3112223111122331101112112121132111310121121301231313113211232113212131211312311111130113010121111113
2113110021221133323032311221103333111103221211131032211312131221111111131221111121112131122113011121
1211021213111111232222011133211122111331132111111111131011133111111131211111021211133213123113110313
3131311121311211123221331031101313131212111121231121233201331111310133131223133310131111132231133231
1211131311331123111233101211311311011112121112210121321123101323221323131133313110121113112213011113
1322231133311131311021112213321031121321312111331131023122222123101311033111133001212211113231131221
2112331211110032311111131321311302313311301130131312021311122102131100311103111131132031101311110311
1211101123133011213330120121301112022101011101212301031111112330211122210112311031011211310112111113
3223121011121113331112132022331020221213111302211111232321123223312110001101310113002111111111112111
1121111113113131031110020012321111111321311121331122212121220220131211211111122131211120102311211211
1133303212320011112111311001311131131012321311311131121301221032230112211213221211312201213111303311
1121101322211130122113103103010321131223121131101112201202201121211313021223130111120123111131311213
1111330311311123111013113302223133232311131101213030101112013101122011131221212111110111111012211211
1123113210211111131013211212110123232112131111111301112111121123312120121122221120231211102113112011
1131211111011213103111223112320110031313311302122101310121130003213112311133211102221231331100113312
1111011311232121313211022131001321312232132111121101111313121112131011101211311113112200121131233311
3211112113101010111021221102323112123333021231111131031103103132112121010111310002112133121221111131
2103131103111131110001200311211111132321200133133212021312211212121312111011101231211123123011130101
3332231331131132131011211122011211110112113223121333213111111113303112133013321012311111223121312110
1111232103112132100131113231012313133111311130111311131213112211312332111110123111013032120111111323
1201100111111321120103113112201312220222123311012131122220231131012122112332113131311333111111131212
3111121332231223311321113201311131211111110120122031112212110313113112111311132211213113010100113221
1131111110211122113011233032102123231330133221132011111001312031333111110321112323123313223110210130
1113131131112301111300312212122332133022311111113131111201312013122323111311031111211013021101131001
2021302303111122310123133222111011312011111112120231101221011111122310011311331201332133212211333123
1112121111211213300101121110202211202111221110031111311023010311212111211310233121003211223121111112
1331111113102311321112132113131223231112221112312011231220111222111031232212131222111112211111221202
