NBNNTHNNNNHTNNTHHBNNNHNNHNBHNTTBHNNNNNHNNTTHTNBNNNTNNTNHNNNNNHHHHNNNNNNHNTHNHNTNNBNBNBHHHNTNNBNNTBNN
THNNNTNNNNHTHHHHNNNNHHNTNNNNNNNNNHHNNTHNNNNTNNNTHHHTNNNNNNNTTNTNNNTHHHNBNHTNTBNTNBNHNNBTNHNTTNBTHHTB
NTBNNNNNNNHNTNTBHTNNNNHNNNNBHNBNNNHNHTTNBBNHHNTNHNBBTNHNNNTNBNHHNNHBNNBNNTNNNNHBTBNNNNNNNTTBTNNNHNHH
TTNNHBNTTNBNNTBNHHNTHHNTHTHHHNNNTNTNNTNHNTNTTHHNNHNNNNNNTTBNNHHNHHHNTNBHNHHTTNNTHTNHNTTTBTNTTNNHNHNB
NNNHTTNHNNNNNHNNNNNNTHTHNHNTTTNNNNNTTNTTNHTNHNNNNTHNNHNHNHTNBNNHNNNNHNNNBNNNNNHNTHTNNNHHNTNTHNNNHNNH
NNNTBHHNNTNHHTBBNBTNNTBHNBNHNNTTHNNHTHBHHHHNBBBNTTNTNBNNTNTTBNNNNBTNTTHNNTNBNHNBTHTHBNNTNHNTNNNNNNHN
NNNNHNTNNHTHNNHBNHNBNNNBHBBNBNNNTNNBBBHHTTHHNTTNNNTNTTNNNNNBNNHNNNHNTNNNNBHHTHNNNNNBNNHNTNNBNBHNTHNT
NHHHNHTNHNNTHNHTHNHNNTBNNTNHNNNTTNHNBTHBNNNNTBNNTHHNNNTHNNNHTNNTNNHNNNNNTBTNNBNTTBNBNTNBNNNHNTHTNNBT
TBHBNNTNNBNNHHNBHTNNNTNHBBTNHNNNBNNNBNTNNNNNHTNTBNNNHNHTNNNNNNTNHTTHNNNBBNNHTHNNTTHTNHBBNHNNNTBHNNTN
NNNNNHTBBNBNNTHNHNNNNNHTNNNNHBTTNNNNBTTHNNNNHNHTNBNNNTHTBTTHHHNNHTTHNHHNHNNBNNHNBNNNTTBNHNTBTTHTTHNN
NBNNNTNNHHTNTNBBNHNTTTNTHTTNHBNNBNNTNHNNHNHBNNNTNHHTTNTNHHBNNHNNTBNNNHHNHTNTHHNNBNNNNTTHHNNBHTHTBHNN
THTNNNTHNNNHTTNNBBHNNNNBTNNNNTNHHNNTNHBNNTHNNNNNHNNNTNNNBNNNNNBNNTHNTTHTNNBNNNNNTNTHBBNNNNHHNNNNNTTB
NTNNNNNNHHNNNBNNNHNHNBNTHBBNHNNNHNNHTTTHNNNNNTTNNNHHNTNNNNNTTTNNNHNTBTTNBNBHNNNHHNHNNNNNHTNHHNNNNNNN
TTHHNNTNTNNTNBTHTTNTBNBBHBBTNNNBNHNTNNTNHNNNNNNHNBNTTNNTNNTTHHHHNTNNBBNHHTNNBTNTBHNNNTNNNHNHNNTBBNTH
TBTNBNTHBNTHNNNTTNNHNBBHNNNBNTHNHNTNNTTNNHNHTTNNNNHNHHHHNNNNNNNBNTNNTTNBHTTTTHNHNNTNHNNNHNHNTTNNHNBN
HNNHHTNNNNHNBTHNBNNTNTNNTTNNNNBBTTNTNHTNNNTNNBNNHNNTTNNBHNHNNTHTNNHNNTTNNHNNNNNTNNTNTTNNNTHTNTHNHTNN
NTNTHTNNBTHHTNHNHNNNHHHTTHNBNNNBHHHNBHHNBHNTNBNNHTBHNNHHHBBHNHNNNTNTNNNNNHNTTBNNBNTHBNNNTBBNTTNNNNNN
TNHBNNTNNNTTTBNBTHHBHNNNBNTHNNNNNNNNNHNNNNBNNNNNTTNTBNBNNNNNHTNHNHTNNNTNNNTHNBNHNNTNNNTNNBNNHNTHNNNN
TNTTHTTNNNHHNNTTNBHNBHHNNNBTTNNNTNHHBNNNNNNNHTTHNNBNNTNNNNNNTBNNNNTTTNNTBBTHBHBHNNTTNNBBHNNTHHTNNTTN
THNBTNHHHHNNBTHHNNBTNNTNHNTTHTHTTBNNNHTNNNNHNNBTNNHNTNNHTNHTNTNHNNHNNNHTNBBNHNNTTNBHNTNTBHTHNNHNNNNH
NNNTTNNHHBNHNHBNHTTHHNHNHTNHNNNHTNHNNHBHNNNNNNNNNNTTHNNNNHNHNNTBTBHNNHNBNNNNHNTHBTNNHHHTBNTTTNHTNNNN
BTNHHTNNTNNHHNNNNTHNNNHNNNTNNNHTTTNNHTBHBNHNNBNTNNNNNNTHNHNHTNTNNTNNNNNHNNNHBBTBNNHNHTBTHNTNHNNTHNHN
NNBNTHTBNTTNHBHBNNBNTHTHNNBHTNNNNBNNBBTHNHTHHHHNNBTNBTNHNTNNNNBTHNNNHBTNNTTNNNNTHHTTNTHNNBTNTHNTHNHH
NBHHNNNNNTNNNNTHTNNHHNBNTTBNNTNNTNTNBHNTBTBNTNBNHNTTNHHNNNNBHNTNNBNBNHNTNHNNTTNNNNBHNBNHNHNHNNNTTNNN
BNHTNNNNTNTNNHTNNNNNBNNHNNTNNNNTHNNNNHNTHNNNNBBHNTHTHNBHBTNTTNBHHNNNNNHNNTHNHNNNTTNBNNNNHTNNNNHNNNHT
NHBNNBHNHNHNHNTHNBNBHNNNTNNHBNNNTNNHNTNNNBTNNNNNTHTNNNNNNNHNNNTTNHHNBNBNBHHHNNNNNNNTTTHNNTHBTHBBNNTH
NNNHTNHNNTTNNBNBTTNHHNHNNNTNNHNNTHHTHTBNNTTTHTNTTNTHTNNNHNTTTTHHBNHTNNNHTTNNHNTHTNBTNNNNNTHNNTNNNNTT
TNHTNHHNNNNTBTBHBNTHNTTTNBTNNNHNHNHBNNNBBBBNTNBNNNBNTNNHBTHNHTNNNBNNNBNBNHNNNTNNNTNHNTHNHNNTNNTNHTNT
NBNNHTBHHBNNNHNNNTHTHTBNBNNNNNHNNBBTBHHNTTTBNNHNNNBHNNNNNNNBBNTHNNNBTNNBNNNTHHBNNNHNNTNNNHBBHHNBNHNT
NBNTHNNTNHHNNNNHNNNNNNTNNNTNNNHBNHTNNNHNNNNHNNNTNNHNNNNNHHBTBBBTNNTNNNNTHNHNHTNNNNTNTTTNNNNNNNHNHNHH
NHNNHTTNTNHNNNNNTTTHHNNTTNNNBNTNNNNNNNNTNHNHNBBHNNHNBNNNNTTTNNTTNHNHBNNNNTTNNTBTNNBNBNHNBNHNNNNNTNNN
NHTNTTBNNTNNTHTBTBNHNNNTBNBHTHTBBTNTNTNTHNNBNNBNHHHNTNHBTHNTNHNNNTNNHNNHTNTNTNNTNNNBNTHTHHNNHNBHNNNH
NTNNNNBNNNTTNBTNBHNHNTHTNNHHNNNNHTNNNTNNNNBHNBNHNNNNNHBNNNTHBBNNNNHNHTHNTNNNHNTNHNTNNHNBTTNTNNTTNNHN
HNNNTNTTBHNHTNNTBTBNNNNTNNNHNNHNNNNNTNHTNNNTHNNNNTNHNBNNTNNBHNTBNTTNNBHHTNTTNNTNNNBNHTNNHNNNHNNTTNNB
NNNNTNNNNTHHBTNNNNHBNNNBNTNBTNTHBHNTNHTTNNNNNHTHTNHBNNNNTTHNNNNNHNHTHNNNNNNTNNHTNTNBTNTHHNHNHNNBNTBN
BNNNNTNTNBTHTNHTNNNNTNNHNTTNNNHBNNNHHHNNNTNTTNNTBTNNBNHNNNTBNTTNNHHNHNTBHNNHTNNHTNNBNNHHHNTHNNTTNTTN
TNNTNNNNNTNNNNNBTNHNNNNNTBBBTHTNHHNBTTHHNTBHBHNTTTNNNHTTHTNNTNTNNNBTHNNHNHHNNNHHNNTNNNNNNTHTNNNTHTHB
HNBHTBNNNNNNTBHTTHNNNNNNTTNNNNNHTNTHBNNNBNBNNTNHNNNNNHHHNNNNTHBTHTNTHNNNNNNHNHHNHNNHBHTTTNNHTNTTTTTN
NNHNNTNNNNNBNTNNTNHNNNNHNNBHNHNHNNTNNTNNNNNNTBTNNNNNNBNBTNNHBTTTBHNBNHHTNTNNBTTNHTTTNNBNHNNTNNNNNNTH
BTNNNNHNTNTNBNNNNNNNNHNBNNNTHHNNNTBNNTHTBHBNHNNNNNNTHHNTNTNNNNNNBHNHNNHHNNNNNNNTTBNHBNNTTNBNNNNNNNNT
BNNHTTHHTBTNNNHTBNHNTNNNTTBNTNNNHTTHHHTNHBNNNBNHHNNNHTNHTTHNBTTTBTNTTNHNNTNNBTHHHNNTNTBNHNTBNTNNNTNN
NNHNNNTNTNNTHNBNNNHNNHTNBTNNTNHHNNNTNNNNTNBNNNNHBTHNNNNBNTTHNTNHNBNTBNBNHHNTNHTTNTNNHHNTTHBNBBTNHNBH
NHTNTNNNNTHNBNTNNNHBNNHNHNNNNHNNTNNHNNHBBNNNNNNHTHNNBNHBNHNNHNNNNNNNTHNTNNBTBNNNNBNNBNTHNTNBHTNNTNTT
NNNBNTHHNHBNBNNHBNTTBHHHNNNNNNHNNNHHHNHTNHTNTTHNNTNHNNNNNHHNNNHNBNHNBHNNNNNNNNBTHHBTNBTNBHNNNNTNNNBN
NNTHNTNNHTNNNBNNHTHTHTNHNNHNNTBHNNNNHTTBHBNTNHNHNNNNNTTTNBNNHNBNNNNTHNNNNTHNTHNTHNHHTNBNNHTNNHNNNHNN
HHNNNBHTTNHTNHNNNNTNHNHNNNHTHNNNHNTTNNBHHNTNNTHNTHNTNTTNHHHTNNHHNTHNNNNHNNNBTHNNNHTNNNTNBTNNHBHNTNNN
NHNNTNNTHNBNNTBNTNTNNNNTNNNNNTHNNTHTNTHHNTNHHTHNTNBTNTTNHTNTNHNHNNNTNNNBNNHNNNTNTTTNHNNNNTNNTNNHNNNN
TNNTNNNBHHNTNHNTNNNTNTTTBTNNNNBTNTNHTHHNNBNTNBNHNNNBNTHNNNBNHBNTBHTTHNHNNNNNHNNHNBNBTHNNHNNTNNHTBNTN
NNTNHNTNHNTNNNBBNTNNNNNNNTHNBNNHNHHHNNNTNHNNNNHNNNNNHNBHHNNHNHNNNNNNNTNHTNNNTHNNNNBNHBTNNNBNNNNNHBNT
NHHTNTTBHNBNNBNNNHNNBNNTNNNNNNNBNNNHNHNBTTBTNTBNTHTNBHBNNHNTNNNNNTNHNBNTNTNNNTTTNTTTNNNNNTNNTNBNTNNT
THNTBHHBNTHNNBNHHTNBNNTHNTNBNHNNNNNHNNTBNNHNBTHTHTTNTHNBHHNHNNHTBBNBNHHNNHTNTNNNBHNNTNNNNNNNNTHTNTNT
NBNNNNNNNHTNTNNNHNNTNNNHNTBNNNNTNTTTBNBNNNBNNHNHNNHNNTNHHNTHHNNTNTHNNTNNTHNHBNNNTHBNBNNHNTTHHNNNHNTN
THNNNHHNNNHNNNHTNNHNNTNNNHNNNNNNNTNNBHTNNNTNBNBHHNHHNHNNNTNNNTNBNHNNTNTNNNTHHHNTTHHNNNHNHNHBNNNNHTNN
HTNBTTNHNHHTNTTNTHBHNNNTHTHNNNTTNNTNNNHNHNTNBNHTHTHTHNBHNTBTBNNNTTTNNNHNHTTNNHNHTBNHNBNTNBNTHHNHHHNN
NNNHNHTNBTNHNTHNBHNNTNNHHTNNNTNNNNNBHNTBNBNNNNNNNNNNNNBHTTTTTTHNNNNHTBNBNTNTNNHHNTNBTHNNNNTTHTNNTNNT
NBNNHBTHHNHHNTHHHNNNBTNNBHNHTNTNHTNTNBTBTTTNHNBHTNNNTHHBNHNNHNNNNNNNNNNBNBNNTTTHNNTNNNNNHNNNTTNTBNNN
THNNHNTNNNBTNNNNBBNNTNHTNTTBNNNTNNNNBNNNNNNNHNNHTHNTNHHNHTNBNTNBBTBNBNBTNTHNTHNNNBNTTBHTNHNBTTTTBNNN
TNTNTBHHBNNNBTNTTNHNNNTNNTTTHBNNNNBTHTNNNHTHNNNNHNBHTHHTNNHHTNNHBNHHTNNNNBTTBNNHHTTNTTHTNNNNNTHTNBHB
NHTNNHTTTNTTNNTNNTNTNTTNNHTHNNNNNBNTBNHTNBNNNNNNNNHNHHNNTHNHNNNTHNTNNHHTBTNBNHTNNBHTBNNTNNNTNHNTNNNB
BHHNTNTHNNBNTHBBNTHHTTBNNNHHNTNBNTBNNNBBTHNNTBHHNNTNNTHNNHHNNTTNBTNTNTNNTHTHHTHTTNHTHBNNHTHTHNNHTHHN
NNHHHHNNNTNHTBNTTNNNNNNBNNNHBNNNNNNNNNNNNBTTHNNNNNTHNNHNNNBNHTTNNTNNNTHNBNNNTHTNTTNNNTHHNNNNHTNHNTTH
NBNNHTHTNHNHNTNNHTHTHNNTTTHNNTHNTNBNHHNNNNNTNNNTHTNNNNNNHNHNNTBNBHNNNHNHTTNNBTNNTNNNHNNNHTNNHNNNHHBB
HNNHTTNNBTHNBHTTHTNBTTNTTBNNTNHNNTTNNNBHHTNBNNHNNNHBNHNHNNHNBHNHHNTNTNTHNHNHNNTTNBHNHNTTNTNNHNNNTNHN
HNTNNTTNNHTBBNHHNTNNNNNBNTTNHNNNHTTTBHNTBNTNNHHTTBNNNHHNNNNBNTHNHNBTHBNTNNNTNNNNNNHNNNNTNTNNBBHHNHNN
HHBTNNNTNHNNTNNHBHNTHNNNNTNHTHNNTTNTHNHHTBHNBBHNNNNTBTNNNTBNHNTHHHHTNNTTTTNNBNTNHHNBNHHHBTNHBHNNTHTN
TTBNNHNNNTNNTNHNNTNNBTTNBHTNNNTHHTTTNNNHNHTNNTNNTNBNNHBTTNNTNNBNNTTTTNNTTNNNNNNNNHTHBNNBNTHHNNTBTNHN
HNHHHBNNNNNNHNNNTTTNNNNTHNNNNTNHTBNNNHNBNNHNHNBNTBNTNTNNNNTHNNNTTNBNBBNNBNHBHNNNTBNHNBBNHNNBTNNNNTNN
NTNNNBBNNNBNNHNNHTBNNNNNNNTHNHNNNNTHNNTNNTHHHBHHBNNTNNTNNNHBTNNTTBTNTHTNTHNNTNTNHHNTNHNTNHTNNHNTHTHN
NHTTBTNNNTNNNTNNNNNHNHNNNHNBTNNNNNHNHNHTTBNHHNNNHNTBNTBTTNTHBHNNBNNNBHTTNTNNTNNNNHHHBTTNNNNNNNNNNTNN
NHBNHNNNNNTNNHHNBHHHBNNHNBNNNBBNHHTHNNNNNBNNTHTHNHNHNBNBHTTBTBHHHHNNNNNNNNNNBBNNTNHHHNNTNTNBNTNNTNTN
NNNNNNNNNTBNNBNHNHNNTNTNNHTTNNTHHHNNNTNHTHHTNNHHNTTNNTHNTNTNTBNHTNNNHNNHHNHBNBTNBTNTNNTBNHNNNHNNHHNT
HHNNNNNBHHBNHTTHHTNTNTNNNHNHBNNTNBBTTNNNNNTNTBHNNNNNTTTNHNNNBNNNBNNNNNHNNTTTBHNNTNTTNHNHNNNNHHHBTTNN
NTNTTNBHNNTTNTNTTNNTBNTNNNTNNNHBBNHHNNNNTNHBNTNNBHHNNNTNNBNTNNNNNNBTNNHNNTNNNHHTHNNNNBHBNBBNHHTHNTNN
NNNNNNNHNNBTHNNHHNTNNNNNNBNTNNHHTNHNNNTNHTHNBNHNBTNHHNNTNHBTNNHNTNHTBTNTTNNHHNNBHHTNHNNBTTBNNNNBNNNN
HBTNNHHHNNNHTNNTNHBHHNTNNNBNHNTHNNHNHHNHNBHBTNNNNBTHHTNNNNNNBBHNTHNNNNNHHNTBNNTNNTNNNTHHBNNHNTNTTTTN
HNNTTHBNTHHBTNNNHHNHNBNNNTTHNHTHNNTNNTNBNHNHTNNTTNTHNHTNNNNNNTNHNTNNHBHTNNBNNHNNNBTBHTNHNNNBBBHTTTNH
HNTNNTTNNTNHNBNNBNBHHNHNNNHHHNNTTNBNHTBNNTTBTBNHNHNTTTNTHNHTHBNNBTNNTTTHNNHNNNHTHTNNNNNNNTNBNHNNHBBH
THNBNTBTNHHNTNNBNNHTNNNTTNTNNTHNBNBNBNHNHNHNNTBNNHTNHTNNTTNBTBNNTBBNNHBNTTNTNNNNNNHNNNNBNHNTNNHBNNNT
HHHHNNNNNNBHNHNNHBNHHNNNTNNNNTHNHNHBTNNTHTHNBBTNTHNNNHNNBTNNTHHNNNHTTTHBNNNTHTTNTTNHNNHHBBTNTTNNNNBH
THHHTTTHTHNNHNHNNHNNTHNHNNTNHNNHNTNBNHHNHNTTTNNBNNNNTNTNHTNNTNNNNNNNTHTNNTTNNNNBHNNTNHNHTNBNTNHNNNNN
HNHNBTTNHNNNTBTNNNNNNHHNNNNNTHTHTHNTTNHHNNTNNNHNNNNHHNHTBNNHTHBHNNNNNTNNNNTHNNTTNNNNNNTNNTTNNHNNNHNT
TTTNTTTNNBTHNTNHNHHNHTHNHTHHNTNTNHHBNTBNNTNNNTNNBTTNHTNBNNNTTNNNBNTBTNNTNHNNNNNHTNBTBBBNBNHHNNBHTHNT
THNNHHBNNTNNBHNHNHHNTHNTNNBHNHNNNTNNNHNBBHNNNBNTNNNNHHHNTHHNHNNNHHHHNNNNTNHHNTNNNHNBTNHTBNNNNNNNHTNH
NHNNTHNHNNNHNHHHHNTTTHHBNHHBBTHHNBHHHNHHHBBHHNNTBTNNNNTNHHNHHNTTTTTHHNHTNBNHBTHTNHHNHHNHNBTTBHNBNNNH
NNBBNNNNTHNNNTNTNNNNBHTTHTNNTNNHTTNBHNHNHNNNNNNNHTBNTTNTTNNHHNBNNTNHNBTHBTNTBHTNBNNNNNTHNNBNHHNBBTNN
NNNHNNTNNNNNBNHHBNNNHHNNNHNNBTNNTTTNNHNBNNTHNNNBBNNHBNNBTNHBNHNNNNBNNHNBNNBNBNNBTNHTNHNBHHNTTTTNNNTN
NHTHNNBBNTNNNNNBHBBNNNNNNNNHNHHNNHTHHNNNTHTHNTNNTBHHNNNNTTHHBNHBNNHNNNBNNHNNHHTNTNNNBHTHNTBHTNNTHHTN
NNBHNTNTNNNBNNNBTBTHNNNNBTNHNBHNTHHNNNNNNHHTNNNHNNNHTTHNNBTHTTBNHTHHTHNNNTHHNHHNNHBBHTNTTBNHNNNNHNNN
TNBTNNNNNNNNNTTTNNNNTHTNNNNNTNTBHHNNHNNNNTHNNHNNNHTNBTNNTNBNNNNBHNNNTHNNNNNTHNBNHNHTNHNNNHTBNNNNBNHT
NBHNNNTNNNNBBNNNHHHBNTNTNTNNTNNNNTNBNTNTNBHNNNNBTTNTNNTNTNTBNHTNNTNTHNNNNHNHNNHNNNNNHNNNNNHNNNTNNNNN
NTNNNNNNNHTTNNNHNHTHHNNTNHBNNTNTHTHNHNNNNNBNTTNHNNNHNHNTHTTNTTNNNHNTNNHNTNNNTNHNTTNNHNHBTNHNNTTBHTHH
NNTNNTNHNTTTTNHHNHBTHBNNNTTNBTTHNTNNNTTNBNBTNHTHNTNHNNHNBNBNNBNNNTHHTNNNBHTNNNTNBHNNHNNNTNNNTNTNNHHN
NNTNBNHNBHBNNNTNHNBBNNBNTNNTNBNNNHTHBTHHNNTHHBTNTTNHBNBNNTTTTNNNTTHTHNNBTHTHNNNNNHTBHHNTNNNTNHHNNNBN
TNHBHTHHNNNTHNNNHHHNHBTNNHNHBHTNNTTHNHNTNHNTNTTHNNTTBBTTNNHNNTNNNNNNNNNNTNHNTBNNTHHTBTTNNNHNNHNHTNTH
NNNHHHNNNNBHHTNHNBNTNTTNNHHNBNNHNNNTNNHTTTNNNBNHNNNNTTTTTNTHHBNNTTNNHTNHNBNNHHNTNNNTNTNNHHHTNNNTNNNH
NTNTHNNHTTHTHHHHBTTNHNHBNTBNHHHNNBHNTNTHHNTHTNNTBNNNNTTNTNHNNNNHNBNHNNHNTHTNBHHTNNNTHHTNNHHNNNNNNHNB
NBTBBNNTTHTNBTNBTNHTNHHBTNTNNTTNNTTNNNTHTNHBTNHNNNHTNBTTBNNNNHTNHTNTHNNNHNTTNHNNTNNNTBNNBNNNNNHHHNNN
TNTNTTNNBTNNBHTNNHTNNNTHBHNNHBTNNNHNTNNTNHNNTNNNHNHNNNNBNNNTBNTHNNNNNNHNBTBTHNNNNNNNTBNNNNNNNNNTHHNN
TTNTNNNTBNTTNBNNNHNHNNNNTNNNNNHNNHNNNHTBBNNNHNNNHTNTNTNNNTNNNNBNTHNBHNHNHNNHHNTNNBNBBNTNBNTNHTTNHNHH
HNHBNNNNNNNTHNNNNTNNHHHHNHNHNNNHNNBNTNNTHNNHNNNNTTNTNTHNNNBNNNTHNNNHNHNTBNHNNNBNNNHNNNHNNNHNNNNNTNNB
