NNHNNBNTHNNNTNHNTTTTTNNNNNNHBBTNNNNBHTBNNNNNNBBNNTTNHNNNNNTNHNHNNTNNNNNBNNNTNNBNNNNTNHHHBNHNNNHHBNNN
THNNNBNNHHNNNNHTHTHNBNNTHNHNHTHTBTBNBTNHNNNHNTNNHNHTNTNNHTHNHHNBTTTTNNBHNBBHTHNNNNBNNHBNHNTNHTNHNNHH
THNNTBNNHNNTTBBHHNBHTNNNNBHNNHNHNBNTBHNBNNTNNNTTNTTNHBNHTHTHNNHNNTTHNTNNTBBNBBHNTNNNTNNHNNNNHBTNNNHH
NTNNNNBNNNNBNNNTNTTHTHNNTNHNNTNNTNNBNNBNNNNHBBHNNBNTNHBHNNHBNNBNTNNNTNBNNNNTNNNHHBNNNNBNHHNNTNBTNNNT
TNHHNHHBNBHNNNNNNNNHNHTHBNBBTTBBHTHNBHTNHTHNTNNNNNNTNBBBNHHBNBNHTTHNTNNNHNTNNNNBNTTTBNHHNNBHNTHHNHNH
HTHNHNTHBNNNTBHNTBNNNNBNHBNNNNHBNNHNNNTNTNHNNTNBNBHTTNTTNNNBTHNBHNTNHNNBNNNNNTHHNNHNNNNNNHHNHTNHNNNN
HNBNNNHNNTHNBHTNNTHNHBBHNTNTHTNNHNNNHHHTNBNBNTNHHTHNNTTNNNNNHTHHNHNNNTHHBNNBTNNNNTNHTNHBTHNBNNHNHTHB
NNTNTTBNTTTTBNBNNNTTNNNTNNNNNBNNNNHNTHNNTHNBHNNNTBBNBNNTHNHNNHNBNNNNHNNHTTNNNNNNNNNTNNBNHTTNNNNNTBNH
NHTBTHTNNNNHTNBTHTBBNHBNNNNNTHTNTNTNNNHNNNTHNBHNHNNNHHNNTHNNNBNHNHNNTNNTTNHTNNTNNTNNHBHNHHNNNHNNBNNH
NNHNTHNNNNTNNNNBHTNNNNTBNNNHNTNHHNNHNNHTNNTNNTNHTTNTTTNNHTTTTNTNNBNBHTBNHNNHBHNNHNHNTNNTHNTHNNTBNNNH
NNNHNHNBNBNNNTNNNHHTNNTNTNBNNNNTNBBBBHNNNHBNHHTNHNTNNHHHTHNHNBNHNHBTNNBNNTBNNHBHNHNNNNTNNHBHHNHNNNHN
NHNNNBHNHNBNNHTNHHTTHHHNNHBNBNNHTNNHHNNNBHHTTNNBTTHNHNTNTHTNBHTTHHTNNTBNHNNNNHHNNHNNNNHNNTNNNBNNBNHN
NNHNNHNHNNTNHNNNNNTNNNNNTTNNBTNNHNTNHTNNNTHTTNHHNHNNTHBNHBTNNTTNHTNHBNTNTNNTNHTHNTBNNHTNNNBNNHNTNHBB
HHNTBTHNNNNNNHNNNHNNTNTNNTTNNNNHHTBNNNNTBNTHTHNHBNHNNBBHNBBNNBNHHNNNTNHHHBNHNHHNHNHNNTNNTNNHNNBNNTNN
HBHNNTNHHTNNNNNTNTTNHNNTTNHNNTBBTTNTNNNNNBTNBNNNTTNTNBTNNBNNHNNNNHNBNNNNHTNHTHNNNHNTNHNNHNNNNBNNNTTT
NTNNNTTHNHTNNTTHBNNNBNNBBTNBHTTHNBBHNNNHTTTNBNNTNHNNNBBBHNBNHNNNHNBNTNNNTNHHNTHNNHHNNNTNHTTTNNNNTNNB
NNHHNNBNHBTNNBHTTNNTNHNNHTNHTHBNBNTNNNBNHTNNNHNNNHNNNNBHBNNNNNNNNNHNNHTNTTHBHBTBHNTNTNNNNBBNHNNNTTTH
NNNTNTTTNTTHTNNNTNNNTNTNNTHNTTNTNNHNBBHNNTTNHTHNHNTNNNNHNBTNTHNNNHNHNHNNNBTTHHNTHNNBHTHTNHNNTTNTNNHN
HNTTNNBNTNHBNTTTHHHTTTNNTHTTHNHHHHTHNHBHNNNTHHNNNNHNNHNNBBHNTNNNTTNHHHHNHHNNTTTNNNNTNBBNNNBHHHNNHTNN
HNTHTTHNNHNNHHNNNHNHTNBTTTHNTBNHNNHHTTNNNHTNHNBNBNTHHNNBNNNHNTNNTNNNNHNBNNHNNNTNNHNHNBHNNNNNNNNNBHNT
NNTTHTNNHNNNNNTBNNNBNNHBTNBNTBTTTNNHNTNTBHHNTTHNTNTNNBNBNNNNTNTHBTNHTHBTHTNHHNNNNBTHTNBTBHNHNHHTNNNN
NBBNNNBTHHNHNNHNHNNNNNNNBHNTHNTTTTHTTNTNTHNNTNHNHNHHBTNNNNNBNTHHHNNTTNBTHNNNTBHTTNHNHTNBBNTHNHTHNNBN
NTTNNNTHNNHTBNHBBTNBTHNBHNBNNNBNNTHHBHNNTBHNNNBBBBTNNNHNHNBNNNNTNNNHTNNTTTNTHNHBBNHNHNNBTNNNHTNNHTBT
NNTNNNNHNHTTNNNNHNBNTTNNNNTNNTHNBHNNTNTTBNTHNTHBNNHNNNNTNNTNHHNNTBTTTNNNHTNHBNBNHBHNNNBNNNTNNHHTBBHT
NNHNBBTHHNHTNNTNTTNNNHTBBNHBHNTNTNHNTNNTNNTHNNNHNNNTNNNHHNBHHTNNNHNHBNTHNHHNHTNNNBNNBHNNTNNTHBNNNNBH
BHNHHBNTNTNHNNTNHNNNBNNHNBHNTTNNNNNBNNNNTNNNHHNNHHNTBHNHTNHTNTNHTTTNNHNHNNNTNHNNNHNNHNTHBNNNTNBHBBHN
TNNTBTNNHHHTBNBNNHTHNTTHBTNNTNNBBNNHHNNHTNHNNTNTTNHNTNHHTBNBNTNTNNNHBHNNNBNNNNNHBBHHNHBBNNNNNNTNNHHN
NNTNNNTNNNTNNNNNHNNNNNHNNNNHNNNNNTNNTNBHNHBNNNHNNTBNBTNNNNNTTNNNBTNNTHTNNBBNNNHNNNNTTTNHNNNBTHBBNTTB
TNNBNTHNTBNNTNTNNNNBHHHNBHNNNNNNBNNHNNHNHNNTTHTNTNNTNHHBBNNHTBNNNTNNTNTNNNNBTNTNTHNTHNHNBNNNNTNNTNHN
TNHNTHNNHBTNNTBHNNTTNTNNNTHTTNHNNTTHNBNNNNNNNBNBNHBTNNNTHTTNTNNNBTBNNNTBNNHHNNNNNTHTTTTNHTNTHTNTTHNT
BNTHNTTNHHHHHHNNNNTTHHNTNNNNNHHBTBNNNHHNNHNHTHTTNNNTBTNHBBNNHTHTHNNTTTNNHTNNTNNBNTNTTBHHNTTNNTNNHTNT
NNHNNHBNHHNHNBTTNTBHHHBBHNNTTHTTNHBTNTNNBNTNNNNBNHNHTNBHBNTHTNNTBNNNTTHBNBBHNTNNBNBHHHHNNNTNBHTHHNHN
BHNTNHTHNNNNTNTBHHNNNNHTTHHTHTTNNBBTBHTNNBNNNNNHTBHNNNTTTHNNNBNNTNNHTBNBNHNNNNHBNTNTHNNNNNNNNNTNNTNB
NNNHTTHNNNNNBNBNBTBTNNNHNNHBNHTNTNHTHNTNTHHNTNNNHHHNTNNNNHHNHNNTNHTNBNBNNHHTNNNNHNTNTHHTNNHNNBHBNNNN
TTTTHTNNHNHBNNNNTTHNNHNHHNNBTHHBTTHBNNNTNNNHBNNHBNBBTNHTHHNNHTNNTHBNTNNNNNNNBTNNTHNNBBNHNNHBNNNHBHHN
TNBNTHNTNNTNHNTTTNNNNHHNBNTNHTTNTHTBBTNHBHHNNBHHNNNNNNTHTHBNNBNNTNHTNNTBNHNTBTTHNTNNNTBNHNTNHTHTNNNN
TNBBNHTNNNHHNTNTBBTNTNHHNTNNHNHNNHNBNNNHBHNHBHNNNNHHTNNNHNTBNHNHNTNNNTNNNTHHNHNHNHBHNHNTTBNNNHNTNNHT
TTNHNNNTNNNHNBNNNNNTBBNNHHNTNNNNNNNNTNNHNNNNBTHNNNNNTNTHTNHNHNNNTNNNTNHNNNNNNHNHNBNNHNNNNBTTNTNHNHNN
NHBNNHNTNNTNTNBTNTNNNNNTNNNTTBNBNNTNNNTNTHNNNTNTTTBNNNTBHTNNHTHTNHHHTNNNTNTNNBHNNHTBNHNHHNNBTHHTNHNH
HNNNNNNBNNTHNNHHNHNNHHNHNHNTNHNNBTHNNHNTHNNHNHHNNNHTNNNNBBNNHBHNTHNNTNBNTHHNTNNTNNHNNNNHNTHTHNTNHHBB
BHBTHNHNNNHNTNTNTNTBHTTHNHHNNNTNNNNBNNTBNTNNHNHNNHBNNTNNNHNTHNHNHNTTHNHNTHNTBNBNNTTNTTTHTNBNNHTNNNNN
TNTTNNBTNTBTNBNNTTTNNHNNNNNTNTTNNTTTNTNBNNNNBNHTNHTTTHNNNHNNNNNNTTNNNNTNNNNHBNTNNNNNBNNNNNNBNNBTBNTH
BNHNBNNNTHNTTTNNNNHNNTHNNHHTNNHNNHNNNTHNHTNHTNHNNTHNNTHNTBBTNNTNNNNNHTNNNTHNNNNHNNTNTNTNNHNTNNBHHNNT
NNNNHHNBNNTNTTTNBHTNNNHTBTBTHBNNTHTNNNBNHHTHTNNHTBHHNNNNBTNNNNNTNHNNTNBNNBHNHNTNTNNTNNNNNHNTBBNHBHTT
TNNHHTTTNHNTHTNNNNHNNTNNTNNNTNTBTNTNBHHBNHHNNBTNNNTNHNNNNTTBNBHNNNNHHNBHNNHHTTHNNNNBHNNHNNBHNTNHNNTT
NNHTHNNNNNHNTHHTBNNNNNNNNHTHTTNNHHNNTHNNTNBNNHNNNHNNTNNBNTHBBTNNTNNNHNBTBHNTBHBNBTNHNNBNHNHNNNHTNNNN
NHNHBHNTHTHBTBHHHBHNNNHTNTBHBTTHHBNNHNTTNNNBTNNTTNNNNNNHHTHNNTBHNNHTTNNBNTNTNHNNNNNTTNBHTHNHNBNHNNNT
NHHNTNNNNBNNHTNNNHNNHHHNNTTNNHNBNHNTNHNTTNNNHNNNHHNHNNNNHNBNNHHHNTNBNTTTBNBBTBTTHNNBNHNHNNNNBTHNHNHH
NTNTHNTNNNHTTBBNTNBNNBHNTHNHTHNHNTTNNNTTTBNNNNHTNNHNNBHNNHHHTNNHNBTHNTNTNNHNNBNTNHNNNNNNNTTTNNHBNNNT
NNBNNNTTNHTTNTTBNHNNBNNNBNNHTNHTNHTNBTNNNNHHTNNTHNNHTNNTNTTBBNTNNNNNNNTHNNHHNNNNNHTTHTNTNTNNHNTHBNTN
HNTNNNTHHNNTTNNTNTNNTNTBNNHNNNNHNNNNNHNHNNHNBNTTTNHHTTNNHTBTNNHNNTTTHTBHHTNTNHNBHNNNNNNHBHNHNNNHHNHB
BNBNNNTHHHNHNNBBNNTTTNTNTHBNNHTNBNBNBNTNNBTNBHNHHTTNNBTNBNNBNNHNNHTNTNTNNNTTTNHNNTBHTHBNTNTNHNNTNHHT
NNNNNNNNNHBNNNNBTBNNNNNNNBNTTNHHNNNNNHHNTHNTTNNNNNTHTNTTNBNBNNBNHBHTTHNNNHBNTBNNNNNNTHNBNNNTNTHTBNTH
NTNNTNNBTHHBNTNNBNNNBNHTNNNNNNHNNNTNNNNBNTNNNNNTTTNTHNHNHTNTHNHNTBNNTHNNHNNTNNTNNTNTNNNTNTBBHTNNNNTH
TNNTNHBNNBHHNNTBHNNNNNHNHHHHNTHTNTBTHNHTHNHNHBNNNNNNHNNTNNNNBHNNNTBNTNHHTNNTNNHTTNHNTTNBNNHNNTHHTNNH
NHNTNNNHTNBNNHNBNNNNNBTTHNTNNNNNBBBNTNNHBHNTNNNHNNTBTBNNNNTHTTTNBHNBTTNHNHBNHNNNNHNTTNNNNNTBTHNNTNNB
BHNTNHHNHNNBHTNNNTTNHNBHNNBHNBNNNNTHNBNNTTHBNBTNNNNBNNBNNNHBNHNNBTTTHNNBTHNTNHHBNTNNTNNHNNHHHBHHNTNN
TNNNTNHBTNNNNNNBHNTNNNHNTBBBHNTHTNNNBTTTNHNNHTNHNNNNNHHHHNNNBTTTNNHNTTBNNNHNHBHNNBTBTNBTNTTNHBBNNNNN
HNNBTNTHNBNBTNTTNTNBNHNHHNHNNNBNHNTBNBNNNNNHNNNBTTHNNTTNTNNHBHNTNHTHBHTHHNNTHTNNNNTTHTHNHTHTNTTTTBBN
BNNHNBHTNTBHNTHBBHNNNHNNNHBHNNNBNTNHBBNTNNTHHTBHNTTNNNNNHHTNNNTNNTTNHNTNNNHTTNNHNNTTNTNNNNNNBTNNNHNT
NHTTNNNNHBNHNNBNHNNTNNNNHNNBNNHHTHNTNTHTTTNHTHNNNNHNBHHTHTNBNBNNNNTNHNTNTBHTNTNNTNBHHNNTNNNHBNTNBNHH
TBNHNHNTBHBNTNNHHNTNHNTNHNTBNHNBNTNNHNNHNNNBNHNTNNHTNHNTHHNNNBNTNNNNBHNHTBHNTNNTNNHBNNNNTNNTNTHNNHNN
TNHNNNTNNNNNHTTTHNTNNNBNHHHNTHNNTNTBHTHNNTNNTNNNBNBHNNNBNNBNNHNHNHHNBHNNNNHBNHTBNTHNNNNHNHNTNNNBNTTT
TNTHTNHHNHNNHNNNHHNNNHNBNHNBNNNNHNNTHHHNNBNNNNHHNHNNNNHNHTNNNNBHTNNTNTTNHNTNTTNNNTHTHNHNNNTTNHNTHNTT
TBNTNNTHNTBNTTNNHBBNNNBHNNBTTTNHHBNHNHHBHHNNTNNNNTHNNHNNNHNNNBBNNNNHNNBNHHHNTNTNHBHTTHTNHNBNNNHTNNHH
NTNTNTTHTNTBNHTNHNHNNNTNTNBHBHNNNTNTNNNNBNTNNTNTBNNNTNNNNBHNHHNTNBNNTTNTNBNHTHNNNNTTTNHNNTNTNHNNTBBT
NNHHTTNNHBTHBNNNTTNNBHHHNHNNTNNTHHNNBNHTNNBNTNHNBHBNNNHTNTHNNNNHTTNNHBNNHNHNNTNNBHTTNNNHNNNHBNHTHHNT
BBHBNTNNNTHBNHTHTHNNNHNNHNTBTNTTNNTTHTHTNNNNNNBNHHTNHNNHNNTNBTNNTHHHTHHTHBHNNHHTTHNNNHHNNNBNNTNTTTTN
NHTTNTNNNNTHNTNNNNHNHHNHHNNNNHHHNHBNTNNHBHHNNNTHNHNNHHBTBNNNTNHNHBNNTNTNHHHTNNHTNNNHNNTNNHNHNNHTNBTH
HNNTNHHHHTNHTTHNHHTHBNNTBTNHNBTHBNBHNNHNHHNTNNNNHHNNNTHNHNNNNTTBNBBNHNTTNTNHNNHTNBHNTHHHBHTNNTHTHNHN
HNBHTNNNTNNTTHTNBNNNHBBNBNBHNNTNNTTNNNNNNNHHHHBTTNNHNNNTNNTTNTNNNNTTNNBTHTBNHNNHBBNTNNTTNTTHNNNNBTNT
TTTTNHNTNNNTNTTTNTHNBTHHBNBTNHNTHNNHHTNNHNHNNNNTNNNBNNNNTNNNNTNNHHTNNNHNBNNBNNTNNTNNBTNNNHTTNNTNHBBN
NNTBTBTHNNNTNNNNHNBNNNTNNTNTTTHNNBNTNNHTTNTNHHTNTNBNNNNNNNNHNNNNTNNNHBNHHTTNTHTNTNHHNNTTNNHNTHNNNNNN
NTHNNNNNTNNNTNNNNHNBNHNNHNTBNHNNNNHTNNNNHHNHHTNBNBTTHNNNHNTTNNNNBHNHHBTBTHHHNNTBNHNBNTTHNTNNHNNHTNHN
NHNTHNNTHHNTTHTNNNNNHTTNNNNNNHNHNHNBTTNNNHNHTTNTNTNBTTTNNNHNNBBHTNNNBNNNHTTBNBNNNNHHNBNBHNHNHTHHTBHH
NNNHTNNTTTHHNTNNNBNNNNNHNNNNHTHNTNHNNHNTHNHNBBNTNBNHNNNHBNHNTBBTNHNNHNHNTHHBTNTHHTNTNHNHNNHNNBNTNTNB
NHNHTNNHBNNNHHNNNTHTNNNNNNNNHTNHNNHHNHNTNTBBNNNNTHNHNNNHNNNNTHNBHNNNNTHNTHNNNNBNNHTNTHNTNTTNNTTHNHNN
NNNHNHNNNHHNNNNNNTBNHHNNNNNHTNHNBNNHHHNNNBHTHTBHNBTNHHNNNTTBNTNNNNHNHNHNTHHNTTNHNHBNHTNNNNTNNNNNTNBN
TNNBNTBNNNNNNNTBBNNHNTNHNNBNNBTNNNBNNNNTNNTNNBNNBTNNTHNHHNNNNHNHNTNBNTNNNNTBHHNTNNTNTNNTBNNNNTNNHHBH
TNNNTNBBNBHNNNNNNBNNNNTNBTNHTHTNNHBNNTNNBHHNHNBHTNNNNBNNHTTNNNHNNTHTNNNNNTNHHNNHTHHBNNNHNTTBNNHNHNNN
NTNHBNTNNNBTNTNNHHHTNNTNBNTNTNNNNNNNBHBTBNNNTBNHTNNNTNNTTNNTNNNTTHTNHNNTNNTHNHTTNTNNNNBHTBHBTBNBNNNN
NNNHNHBBNBHTHBNTNNNNHNTNNHTHNNHBBNNNNNTNTNNHBBHNNTHHNNHTNBNTNNNNHNNHTHNBNNHNHNTBNTTNNHHNTNTNNHHNNNNT
NNBNNHNNNNHNHNNNNNNTNTNHTTTNNHBHHTNHTNNNNBBNNTTTTNNNNNHTTNHNNNTNTHNNTNNBNTNNNNNHNTNNHNNBNBNHNNBTNHNN
NNNTNNNTNHNNNTNNTHNTNNHHHNHHNHHNHNBNNNBTNNNNNNTNNNBNBBHNNNNNNTTTTTHTNTBNNNNTHBTTTHNBTNTNTNNHNNTBHBNT
HTTHNNNNNTNTHTNNTHNNBNNNHHHHNNTNNNHBHNNHNNNNTHNNHNHTNNNTTNNHHHTBNTNTHTHNNHBNNBTNHNNBTTHNNNHNNNTNTHNN
TNHNNBNHNNNHTNHHTNNNNTHBNHNNHNTTNNBNNNNNHNTNNTNHHNTTNNNTHTHNTBTHNBNNHNNHNHTNNHNTTTTTHNNNHNTTTHNNHHNB
NNTNNHNBNNNNTNTNNNBNNTHTNNHNNNNTNTTNNNNBNTBHBNTNHNNTNNNTTHNNTTNHNHBHNHNNHHBTNTHHNTBNBBHNNBNTNTTNHNHH
NTTNNNNNNNNHNTNNTHNNTHTBHNHHHTNHNBNHHNHHHNNHNTTNNTNNNHHNNNNNNHTNNNNNNNTBTNNHNNBNHNNBTBHTNNNTNNTNNTNN
HHBTNNNHHNHBTTNHTBNNHBBBTHTHNNTHNNTNNTNTTBHBNBTNHTHHNHNNHNHNBNBHNHHBNTNHTNNNNNNNNNNTBNHTHHTTTTBNBNHH
THNBTBNTNHNNTNNHTHTTTHNNNHNNNNTHBNHHTBNNTNNNBHHNTTHNNNNBBBBNHBHNNNHTBHNNHHNTNNHHNBNNTBHTNHNTTHTTTNNN
NNBTBHNNTNHNNTBNTTNBTHBHTNNNNNNNNTBTHNNTNNNTTNNBNHNBHNTHHNNNNHHBNNTNBTHHTTBNHHHTTTNNBHNHNNNHBNTNTTTN
HTNTNNHTHNNNNNBTHHTTNNTNHHBNHNNTTNHNNNHNNHNNTTHNNBHTNNNHNHTNHNNNNNHNNNNNNTHNNTHHNNHTBTTNNNBNTNTNNBTN
TTNNNNBNNNNNNHTNTTNHNNTNNTHNTNNNHNNBTBNNNHNNTNNBNHNBTNHTNNNHNTNHNHNBNBNTHNNNHTNHHBNNHBNBBHNNBTNTNBNT
THHTNHNHNTNNHNNTNNTBNHNHNHBTNNNNTHNNTNHNBNNNNNTNTNTBHNNNHHHNNTHNNTNTNNNNNNHNNTNNTNNNHBHNBTNNBNTNNTHN
NBBHNNNNNBNTNTNBNTTHTTHNNTNNHNNHNNNNNNHBTTHTNNNHHHNTHNNBNHNNTNNNNNNHTNHNNNTNBNNNTNNTNNTNHTNBNNHNTNNN
HNTHNNTNTNNTTNNHHHTNHTNNHNHHNTTHTNNHNNHTHBNHNNHNHNNNNTTTNNTBTNNBBHHHNNTNHTBNNBTHNTNTNNHTHTNNBNNNTTNN
TNNHNNHNNTTTHHTTNHHHHTNTBTNNNBNNTNBHNTNTHNNTHNNNNNNNTHHNNBNHNTNTNHNHHNNHTHNNNTNHNNNNBNNNTNNNHBNNNHNT
TTNTNNTNTNNNNBTNHNTNTBTNTNNHTBHTHHNHNBNTNNHHNNHNNTNHHBNHTNNNHNHHBNHTBTNHHTTTTNNNNNNBNNTNNNHNHNTNBNNN
NNTHNNNNNTBTHNNNHNNNNTHNHHBNNNNNNHHNNHNTNBTTNNNHNNNBNNNNNNBNNBNBHNNNNNHTTNBTTNNNNTNHNNHNNHNNNHHNNNBT
TNHNNNNBNNTTNHNNHBNNHTNNHBHNNBNNNTTNTHHNTHHTNNNNNTNNTHBTNHNNHNTNBHTBNNHNTTNNNHTNNHBHTHHHTNHNBNNNHNNN
