TNNNHNNTTHTNNNTHNTNNNHBNHTTTNHNNNBNNHHHNBTNNHNNNNNTBTBTHHTBHBNNHNNNNNNNTHNNTHNNNHNHNNBBTNTNNNNNNNHTN
NTHNHNTTTNHNNTBNTNNHNNHNTNHNNNBNNNNBTBNNTHNNHNBBHNHNHBHNHHNHNTNBTNNNTBTNNNTNNTNTNNTHTBHNTTNNNBNNNNBN
HNTHHNNNTHNNHTNNNTHNNTTTNHNNHNHNNTNTHTNHNHBNHTBHNTBBHNTHNNHTHHTHBNTHBNTNTBNTBNHNHHTNNTNTHNNNNNHHHNNT
NBNHNHNBBNBTTNNTNTNNHNTNNNTHNNTNHNTNHNHTTNHTHNNTBBNNHNNTNNNHHBNBNTBHTHNNTHTTNTNNNHNHNNNHBBNNTHNTBNBT
NNHBNTNNNNNTHNNTNTNHTHTNBNNHTNTNBNNTTNNNHHHNTBNHNNBTHNHTBBNTNNBNNNTNTNTBTNNTTBHTBNNHNHNNHTNNNTNBBTNH
NBTNHNTTNHHTTNNNNHNNNHHHBNTTHHNHNTNHNHTHNNNTHNNNNBNNNTNHHNNTNHNHNBNHNNNTTHNNBNBHHTNTHNBHNBBNNHNNBNNN
TNNNNTHHHTNHHNHNNTHNNTNNHNTNBNHHTBTNNNNNNTHNHTTBNTTNNHNNHNHNHTTNNNTNBNTNTHNNHNNNBBNNNNNNNTNNNNNHNHNN
TNTNTHHHBNNTBNTNNTTBNHBNNNNHNNTTNNNHHBNTTNNHNNTBBTBNNTNTBNNNNNHNNNNBTTHBHBNNBTHNTHNHNHTHNNNBHNHNTNHN
BNNNNNTHNNNNNNNBTNNNTNNNNHHNBTNNNHBHNNNNNNHNHTNNBHNHNTNHHTHBTNNHHNNHNNHTHNNNNHHNBNHHTNNNNNNTTNHBNTTT
HBNNHHNHNNBNHNNHBNHNNNNBNNHHNNNNNHHTBNNTNNHBHNNHHTTHNBNHBNTNHHTHNNNNTBBHTNNNNNNNNTNHNHHHHNNNBNTTNTNN
HHNTNNNNBHNNHNHNNNHNHNNHNHNNHNNHNNNNBTNNHNNNBTNHNTHTHNTTTHHNTBHNTNNNNNNNNTHBHNHNBTHNNNHNNNNTNNBHTNNT
NNBNHNTNTNNBHNNNNTBNTTNNHNNTNTHHNBNTNHHTTHTHNNTTHBNNHTNNTNNHTHHBHTTNHNNNTTNNHNTNBNNBNNNTBHTNTNNTBNTN
NTNTNHNNNNTNTTHHNHTNNNHTHTNTBTNNTNNBTNNBHBTNNBTHBNNNNNTNHNNHTHNNNNBTHNHTTHBTNTTNHTNNHBTNNTNHNNNTNHBN
NBHTHNTTHNTHNHNNHTNNNTHHHTNHNNHBNTHNHNTNHHHHNHTNNHHTNTNTTNNTTHTTHHHTHTHNTNNBNNHNHHNNHHNHNHBNNTNNTNHN
NTTTTNHTHNNNNNNTNNHNHNTNNHTTBTHNNNNBNTNBNNHTBTTNBNNTNBNNHTHBTTNTHNTTHHHNTTTTNNTNNNTTNBNNNHTNNNNNNHTN
TNTBNTNNTNBNNNNNNTHTNTNBHNHHHHTNTBTHTNNBNNNNHNHTNNNTHHTNNNNTBBBTNHBHNTHTNNTNHHHNNNBBNHNNHNHHBNNNNHNH
NTNNNNTBNNBHNNNBBTHTNNHNNNNNHNNTBNNNTBNNHNBNNTNHTHHTTHHBTNTNNTNHNTTBHNBTNNTHNNNHNNTTTHNNTTHTNBNNTTHN
HTNTTNNHTTNNNHTNNBTNNTNNNNNNBTHTNTBNTHNTNHNNNNHHNBNHTHNNNNNNNTHNNNNNNBBNTNNBTHNNNNNNBNNNNBTHBNHNTTNN
HNNHTNHHTNNNHNHHNNNTNNNBHBTBNNNTTNBNTTNHNHNNBBNHNTNTTBNHTNNTNNTNNHNNHNBNHNNNBNHTNTNNTNTNNNNBNTNBTNTH
HNNNNTNTNNNNHHTTNHNNTTNBNHBNHTTNNNNNHTNHNNTNHNNTNTNNNNHTBHTNHBBTHTNNBNHNTHNTTNTHBNTNTNNNNTNNNNNNNNTN
NBHTTNHBNNHHTNBNNNTHHBTTTHHNNNNNHHNTTNTNHNNTNNBNNNNBNTHNHNNNBBTHNNHNTHNNTHTNNTNNNBTNTHNNBNTNNHNNNHNN
BNHBHNTNTNNNTHHHNHNHNNNHHTHHHNTHNTNNNTBHTHHNTNNTHNHNTNTTNNHTHHNNHNHNTTNHHNBNTNNNNBNHTHNTTTNTNHNHTBNT
NBNTNBHTNHNBTBNNNNNNNNNNHNNNHTTNNTHBNTNHNBNBNHHTNHNNNHNNTNNNTTBNNHNNNNTNNNNTTTNHNTNHTTBTNTHTNHBNHNTN
HNTTNNNNTHHNTHHHTNBTNNNBNTHHNNTHNNHTHNNNHHNTNNTTHNNHHNTBNHBNTTBHNNNNBBTNHTNHNBTBNBNBTTHNNHHNBBNNNTNT
HNBNNNTNNNNTNNTNHTBNBTNHTHTNHNBBNTTNNBBNTNNNNTNTTHNHTBNTNHTNNNTHNNHNNBBNNNNNNNNNTBNNTNNNNTNBHTNNNNHN
TNNNTTNNTHNNNNBNNHTNNNNBTTHNNNTNNNHTBHBNBHBNNNTNNNNHNNTNNHNHNNNBNNNHTBHHNNHNBNNTBHNNTTNHHTBTTBHNNNNH
TNHNHNBNTNNHTTHNHTBHNNHNNNBHNNBBNNNNTHNHNNTTBBHNNNBNNNHNNTNNHTBNHBNNTTHNNNNHBBNNNTTTNHNNHNBNHNNNHNNN
NHTTBNTTTNNHHNNBNNNNNNHHHNTNHNTTTNHTTTNTHNTNNTHTNHNTNNNNBNTNNNTBNHTHNNNNNHTTHNNBNNBNHBNTTNNTHBHTTHNT
NNNNHNNNBNBBTBNHHHNTBBNHNNNHNNHHTNNNBNTNTNNNHHBBTHBNNHNNTNNTNTNNTNNNHTNNNHBNNNNBTNBNNHNTNNHNNBNBBTHN
HTTHHTHNNNNTNNTNNBNNNTBHNHHHNHTBBTNTNNNNBNHTNNTBTHNTHNTNNTTHTNHNHNBNHNNTNTNNBBNNNHNNNHTTNTHNHTNNNTTN
NHNTTTHTNTNNNHHHTBTNNHTTNNTNTHNHNNBNHHNNNTNNNNNNTTNNTNTNTBHNTNHNTTTNNBNNHNHNNNNTHNTHNHTTHNTTBNHTNTHT
BNBNBNBHTTNTTBNNNTNNHNHHHNNBTNNTTTNTNNHNHNNNNNNNNNNTBHNHNBNTHHNNNHHNTHTHNNNBNTNNNNNTNBNHBBTNNNNTNBNN
BHNHNHNHNNNTNNNNBNNTTNHTNNNHNBTHBHHHNBNTNTBHNNNNNHNNNNTTHHBBNNTNBNHNNNNNTHNNNHHNBNTTTTTNNTNTTNNTHNNH
NNNNNBNBNNNHNTNBBHHNNNBNBNNNNNNBNNHBBHHNBTTTHBNTBNNHTNHHNTBTNNNNNNHTNTTTBNTTNTNBNHTBNNTHHTNNNNNTHNNN
NNNNTNNHTNHTNNNBHNTHNHNTNNNHNHTNTHNNHBTHHNTNBNHTNNNHNTNNNNNNNNNHNNNBNNHNNNHNNTHNNHNHNTHTNTNNNNHNNNNN
TNNNTHNHTNNNNNNNTNNHNBBTNNNHHHNBNHNNNNNNTNNNHTNTTHTBNTNHNBTHNNTNHNTTNNNNTHTTTNHHNNBNHTNHNTBBNNBNTBNT
BNNNNNTNNNNNNNHNNNTTNNNHNNTTNTTHTHNNBTNNHNHNNNNTHTNNTNHHNHNHNNNTBTNNHTNTBHHNNNNNNNNNNHBNNHNTNBNTNNTB
HHBTHHTNNTNNNBHTHNNTNTBNNNNHNNTNTNNBHNNTTTHNTNNNTNTNNTNNTNNNNHHNNNBTNBNNNHTNTHNNHNBBNHHNNNTHBNNTNHNH
TNNTBNHHNNTNBNHHNHBNNNNNNNHNHTNNHNTTBNHNHNNTNNNNTNNNBNTTHTHHHHHNNTHNNNHHNNHNTNNNNTTTTHNNNNNBTNNNNTNN
NTTBNNNNHNBNNNTBNTHNNNBNNNTNBNBNTTTTNTTNBHTHNNNNNNTNNHNBNNNHNNTNTTNNNNTHNHNHNBNNTNBTTHNTNNBNNTNTBNNN
TNNHNBBTNNTHHHHNTNNNTTNHTTNNNNHNNHNHNNNTTTNNTNBHHNNTNNNNNNNHTNBBHBNTHNNHNHHNTTTHTHNTNBNTNHTNTBTTTNHT
TNNBTBBHNTBNBBTNBHTBNNNHNNBNNNNNNTHNNNTTNTTNNHNHBBNHHNNNHHTHHNTTHTTNNNTNNBNTHTBNBTNTTTNHNHNTHNBNNNHN
HNNHNHNHHBBHTNTNNNHHHNTNNNTNTTHTNHHNTTNBHNTNTHNHHNNBNNNNNNNNTTTHHTBHNNNTTNHNHBNNNBTNNNTNNTTNNTTTNNHT
TNTNNNNHTHNNHNTNHHNNHTTTNHNBNNNTHNNNNNHNNTHNNTNTHNBTNNNNHHTTTTNNNTTBTHNTNHNHTTTBNHNTNHTNHNBNTTNNHBNB
NTNHNNBNTHNNNHTNNNNNTTTNHHNTNHNTTTNTNHNTHNHTNNTTHTNTBNBNNNHNHNBHTNNHNTNTNHNHNHTNTNNHNNHNNNNHNNBNTNHH
BHNNNNTNNNBNTNNHHNHNNNHHNNNHHTBHTNNNNHNNTTTNNNNNNBBTTNNNTBNNBBNHTBNNHTTTNTNHTNHTTNNNTNNNBHNTNTHNNHHH
TTBNTNHTHNTBNBTNNTTNHNHTHNNNNHNBNNNHHBTHHHBNNNNNNNTBNTNNNHHNTNHNBNHHNTNNNNHBHNNNNNHHNNTNNHHTNNNHNTNN
NTTTTTNTNHNNHBNTNNTNNHNNHBBNNTNNTHNHBBTNBHBHTTNTNTNHNHNNNNNBTNTBHBNNNTTNNNTTNNTNNNNNTNNHTTNNNBTNHNNN
NTNHTNHNNNNTBNNTNHBTNNTNNNBNNNNNHNHTNNTTHHTNHNNTTNNTHNNBTBHNNHBHTNHNNHNHTTTNNBNHTNNNNBHNNTNTHNHTNHNN
NTNNNNNNNNNHHTHTNTNHNTNNHHNNNTTHHNNNNHNNNNTNBNNNNBBNNBTTTHBHTNNNTNNNTNNNNHBTBTTNBHNHNNNNTTHBNHTNTNTT
THNHTHNNNBNHBBNNNTNNHHNNNNBBBNTNHNNBTTBHNHHHHNBTTTNNNHTTNBTNNHTTTNNHNNHHNNNHNTHHNTNTNTNHNNBTHNBBNTNN
TTNNNNNTNHTTHNHNNNHBNTTNNNNNNTHTNHNHTHTNNNHTNTNNNTHHBNHNHHNNNNHHNTNBNHTNNNHTBHHTHHHNTNNNHNNNHTTNNTTT
THBNHHNNHNNNNNBNTTNHHTNNHNHHHHNNNTBNTTNBNHHNNNNTNNHNNNNTNTHHNHHHNNTHHNNNNTHNNHTTNNBTTBTHTTHHHNTTNNHN
NTTNNNNHTTNNTBNTHNBNTNNNHHBTTHNHNNNHHNNHTNTNNNTHHTBBNHHTBTTNNNNNNNBNNNNNTNNTTNNNHNNNNNNNNTTHHNHNNHBN
TNNNNNNTNNTHNTNHNNTNNNHHTNHHNNNHNNNNHNNNNHNHNNNNNNNNNBHBHHNBNHNNHNTHNNNNNNNHNNBBNBBNNBTHNTNHNNBNTNNH
BNNNNNNHNTBNTTNNNNNNTHNNHHBHNTNNHNHHNNNNNNNNBHHNNBHBBTNHTNHNHNTNBNHBHNTHTHNNHNNNBNTNNNNHNNNNHTNBHBTB
HNNNNHTTNNNNNNNTNTBHHNHHBHTNBNBNNBNTNNNHTNNHNNBHNNNNNNNNTNTNNNTNNNHBNNNNNTBHNTTNNNHNNTBBTTNNHTNBTTNH
TNTTNNNHHHNHHNNBNTNTNNNHBHTHNTNHBHNBTHBNNNHNTNNHNBNNNNNNNTNBNNBNHNTHTNHNHNNNNNNNNTNNNBHNHHHTBNHNNNHB
TTNHTNNNNTHNNNNNTHNHNNHNHTNBNNHNNNHNNHNNNTHHNNNNHNNTNTTTNHBNBHTTNNNNTNBBTNTNBNTBTNNHNTNHNHNNNNBTNTNH
NTTNNHNNHNNNHTTBNTNHTNHTNNTNHNNBBBHNTNHTNBNNTBNNHHNNHTNNTTBTNNNNNNNNTNHNNTHTNHNNHHTNNBNNNNNHHNNTNNNT
NNTBBBHNNHHNTTTTNTHNBHNNNTHNNNHNNNBBTHNNHNHTHHTNNNNTNNNNNNBNNHNNNTBBTNHNTTBTHHNNNNHNHHHNNNNNNHNHNHBT
TNHNHBNHHNBHHNNNBHNNNNTHTNNNNTNNBNTHTTBTTNTTHNHTNNTNTTTBBTHNNNNHHNNTTTHTNNNNHNNNNHBBTNBHNNNHHHHNNNBN
NHBNNNNHNTNHHNTNNBTTNNTNNHNBNNNNBBTTHHNTNHTTHNHNHNHNNNHBTTNHNHNBBNNTHTNTTNNHNNNNNHNNNNNNNTNNHBBNNNNH
TNHNNTNTNNNTNNNTNHNNNNNHNNNHTTNNTHNTNNNNTNNTNTNTHTNBBTTNNNTBNHTNNNTNHNHNNHHHNTHHHNNTHBNNNBNNNNNNTHNN
HNTTNNNNHNNTNHNNBTHHTNNTHNNHNNNNTNBHNNNTNTNTNNHHHBBNHHHHHTNTBNNHNNNTNBHHTBBHHHHNBNBTNNNNHNHNTNTHNNHT
NHBTNTTBTTNNNNTNTNTHNHNHTNTTTHHTBHNHNNBTHNTHHHNNNHHTHBNNTTNNTNNHNNTBTNNHHTNNHTHHNTTTHBTBNNHBNTTNNNNN
NHHNNNBTNTBTNNNHHNHNHBTNNNTTTHNHNNNBNBHTNHTNNNNNBNNNNTTNNNTNNNBNTNTBNNTNTTNBTBNNBHHHHNNNBTHTTTNNNNNH
HNNNHNNTNBNNNTHTNNTNTBNNBTHNNNNTNNTTNBNNHNNBTHNTTTNNBNTNHNHHNHNNBTNNBTTNNNHBNNNNNHNNHNNTTNTTNNBNTNNN
HTNBTHNNNTNNHNNBNNBNNNTNNHBTTBNHNTHTTNNNNHNTBBNTNNTHNHHNNNNTHTHBNNHNNNNTBTTNHTHNNNBHNTNTHTNNNNTHNBNT
TNTNNTNTNNTNHHTHBHNNNNNNNNNHNBHNHNNNNNNHNHTTBNNNNNNNNTNTNNHHNHNTNNHNNHHNBHTHTNBNHNBBTTBBTHTNTTNNHHNH
HHTBHNBNHBNNHHTNBTHHHHHNNNTNBNHNNNHTNNNTHBHHNBHTBNTNNNTTTHNTNBBNBTTHTTNNNHNBTNHBTNNHHNNNNTNNHHTBNNHH
NNTTTBNNNNNHHTNHNHHBNHNTNNNNHNNNNNHTHNHNHBHTTHHBNNHNTNBBNNNHTHNNTNTTTNNNBBNBNHNHNHNNHNTNNTNNNTNHNNBH
HTNNNTNHNNNBNNNNNNTHTHTTNHBNTNNNNNBTHTHNNHTNBHNNTNNNTBNTNNNNNHNTTHBTNTTHTNHTTHNBHHNBHTNBTHNBNTTHNNHN
TTTNHBBNTNTTTTHHBNTBNNNNHNTNNNNNNNTNNNNBTHHBTHNNTBNNHHHHNBNNNHBNNBNNHNHNTNNNTHNNTTNTNNNHBHNBNHNNTBTH
NNNNNBNNHBHNTNHNTNNNBNTNNNTNNTNHHTNTNHNBNNNHNTNNTNNNHNNNHNHHNNNBHTHNNHNTHNTNTHNNTNTHTNNHNNTNHNHHNHNN
NHNTNTNTNHNNHTHTBTNNNNHNBTNNNHNNNTNTNHNNNHNTBNTHNHBTNNNNNNHTNBHNNBNNTHTHNNNHNBTHTBNNNNHHHHHHNTTBNNNN
TTTNNBNTNNNBNBNBNNHTNHTNTNNTTBHTNBTNNHNNNNTBTHNNNNHNHTHTBTBTNTHBNTNNHTNNNBHTTHNTNHNTBBHHHNNNNBNBNTTN
THHNNNBHHHBNTHTTNNNHTTTBNHHNNNHHNBNNHTNNHNNNHBNHNNBBNTHTHTTNHBNHNTHBNNNTNTHBTHNBBBTTBNNNHHHNBNNTNNNN
NHTHTNNHNTBNTNNBNNBTBBHTNHHNNHNTNBHBHTTHBNNNTNBTHHNTNTTHNHNNBTHTTNBNTHNNNNHHNNHNHNBNHNNNTNHNHNTNNNTT
HNNNBHNNNHHNNTTNNNNNNHNNTBNHNNNNNHNNHNNNNNTTTNNTNTNNNTTTNTNNNNNNTHNTTNHTNNNNNNNTHBNTBHNNHHNBHHNNTNNN
NTHNNHTTNNNNTNNTNNHNNBNNNNNTTTTHNHTNTTNNNTTBTNTNTTTHNTNNHBTBTNHNNHNNNHNTTNNHNNTNNHNNHTNTNHBHHBHTNNTN
NNBNNTHNTNNTNNHNTHBHNHNNNNNTBTNHHNHNNNNNNNNNNNHBHTHTBNBHNTNNHTNNNHHTTHHBHHHHNNHHNNHTTTTNNNNNTTNNTNNB
NBBNNNHNNNNTBHNNNTTNNNTNBHNNBNBBNNHNNHBNNNNNNTNHNBNHNNTNNNNTTNTTNTHNNHNNTHTTBBNNNHTNHNNHTNNNHNTNNNHN
NNHTNTBHNNBNNNHBBTNNNNNBBNNHNTBNBNHNNHNHNBBTTHHTHNTNHNBNNNHNTHTNNBHBTBNTTTNHTNHNHBNNHBNNNNTBNNNNNHHN
NHTTTHNNNNTNHNTHNNHHNNNNNNHNNBTNTTTNNNTTNBTNNHNTHTBNNNHNNNNNHNTHTNNNNBBNTHHTHNNNNNNNHNHTNNNNHTNBHTNN
TTNHNNNNTNNTNTTTHNHHTNNTTNHNBNNNNBNNBNNNNTHBNBNNTNNNHNTTBNNHNTNHNHBTTHNHNHNBHNNNNHNNHNHHBNNTBTTNTNNB
HNHNBHNHBNNHTNNNNNTHNHBBNNTNNBNTNNBNTNBNBTTNNTBHHTTNTNNTBHNNTHNNTHHNNNNNNHNHNTNTNTNNBNBBTNNHNTNNHNHH
NNNNHHHNTNNNNNNNHNHNHNTNNNNNBHNTNNBHTNNNTHNHNNHHNNTNTNNTHNNBTNNNNNBHNHTTNNHHNHTNNHNNHHNHNNHHHBBNNNNN
NBTNHNHNNNTNNNBNBBNNTBNNNHNNNTBBBBNHNHTNNNTNHNNHHNNNBHNHTTNNNBNNNTNTNBHNNNNNNTHNNTNNNNTHNHNNNNTNHHNN
NNNBNTHBHNNHHNTNNNHNNTHTNBHNNHNTNNNTTNNHHNNTHNBNNNNTBBTNNNNBNTNNNNNHTNNHTNTNNNNHTNBTTTTHBNNNNTHHHHNT
TNBNBTTHNNNHNTTNBHNNNNHBNTNTNHTNNBHNNBNTHTTBNNNHNTTHNNBBBNNNTNHTTTTTNNNNNNNHTHNHTNNTTHNHTTNNNNHNTHTN
NNNTTNHNNNTBNNHHNBNNNTNHTNNTNHBHHNTHTNNTNBTHTTTNBNBNNHNHNNNTNTTTNNNTNHTHTNHNHNHTNNBNBBHTNBBNTBHHNNHH
NNHBTNBTNHNNTHNNNTHTBNBNHNHHNNHHHNTTNNHNBHHNNNNTBHNNHNNNNNNNNNBNTNTHNBNNNTNNHNNHNTTNNTNNNNNNNBNNNNNH
BNTHHHNHHNNNNTNHNNNNHHTTNNBHNNBHTNBNNTNNHNBHNHTTNNTTBBTNTHTHTNHNNBNNHBTNNNBHTTTTNNNHTNHHNTNNNTTHNNBB
HNBNHTTTNTTNTTNBBNHNTHTNHBNNNNNNHTNTNNBNNTNHBHHTNBTNNHNTHHHTBTHNNBNHNHTNNHHBNNNNHNHBNNNNTNBNNTNNTBTN
THHBNNNTNHNNNNNNNNNBNNNNHHNTTNTNNNHNTNTNHNTTTNHHHBTHNNNNTNHNBTNBNNTHHNNNHTNNNNNNNTNBNHNHNTBTNTNTTNNN
HHHNBNBNTTTTNNNNNHHNNNBNTTNNTHNHHTBHHTNHNBBTNNNBTNTTHTNTNNNNNNNHNHHNTNBNNNNHTTTNHTHNNNNNNBTBNHTNHNNN
HNHHNNNTNBNNNTHTTNNHNNBNNNTTBNBNNTNTTHHNNNNHBTNNHBNNTNNNNBNNTHNTNNHNNNHHTBNTTNHHHNNHNNBNTHHNNBNNBNNN
NTHNNNNTNNNBHHNBTBTHNHHNNTBTNNBTNTNNHNTNTNNHNNHNNNNNNTNNNNHNNNNTBNTNHNTNHNHHTHTHHTTNNNBNHHTHTNNHNNNN
HTBNNHNBTTNNNBNTHHNTHNBBHBNNBNBHNTNHNNNNNNHHNNBNNBNHNNNNNTNBNHNBTHNBHNNNNNNHNNNHTBBBNBNTNNTHBNNNNNNT
