TNNNTTBNTTHNNNHHHNNNNBNHHNNHNTBNHNNNNTHTNNTNHHHTBHHNNTNBNHNTNNTTNBHTHNHNNNNBBNTNNTTTNHNNTNHHTHTNHNNH
TNNNTNTNNNNNNTNHNNNHNTNNNHNNTNTNNTNNTHNBNTNNTNNNNNNBBBNNNTNNTNNNNNNNTHTBTNNNNBNNTHNNBNTTNNHNNHTNNNNB
NNNNHBNTHNTTHNHHBNBHNBNHTNTHTBNNNNHTNHNTTNNNNHNNTNBNNNNNHNBBHNNTNTNHHBNNNBTNNHNNNHHNTBNNNNTTTNHBNNNN
NBNHNNNNNNNTNTNTTHNTNNBNTNNNNNNBHHNHNTNBHBNNHNNTHHNBNNHTTHHNTHNHHNHHNNBHNNNNHNHTNNHTNNHTTHTBNNTTNNNN
BTHNNNTNHNNNTBHBBTBBTTNTNNHNTNNHNHNNNNNHNTNNTHNNNBHHNNTTHNNBTTNNBHTNTNHBNNNNTNNHNNNNNTBTNBNNNNHNBNNT
BNTTTBNNNNNNBTNNNTHHNTTNHNBNTTTHNTNNHNNTBTNNNHHHTTTTTTHTHHTNHNTNHTNTNNHNTNBHNHTBTTNTTTHNTNNTNTNNHNNH
NHHNNBTBNBNNTBNTBHBNNNHBNNNTNTTNNNNNNNBNHHHNNNHNTHBHTTBHNNNHTTNNTNNHHNNTTNNHNNHTBNNBNTNNNHNHNNHNHNTH
HNHNHNHNTNNNTBNTNBNNBTNHNHTTHNNNNBTNTHTHNNHNTTNHNNBNTBBNNNHTTNTNNBNTNNNHHNTTTTNNNHNHHTTNNTTHTNNTHHNH
NHHNTHNBTBNTNHNNNTNHNNNHNHNBHTNNHNNTNNHNHNHTNHNNNNBNBHNNTTNNNBTNHNTNNTNNNBNNBTHNTNNNNBHTHNHNBBNHNTTB
NTNHTNNNHNHHHNHTTNTNNHNNNHBNNHNNBNTNNNNBTTNBBNHNNNHTTTNNNHTNBHNNHTTNNTNNNNHHHTHHBNTTTNHNBTNBHNBTHNTN
NTNBHNNTNHNNTHBNNTBNNBBHHNBNNBNNHTTNNHNBNHNBTTHNTNNNHNNHNNTTTNHTNTNHNHNTNNHNHNHBHNNNHNHBTNTNNNNNNTNN
NHTNNNNTNHNTNHNTTNTTNNTNNHNNTHNNHHTTTTTNNHNNNHNTTHNNNNNHNNNNBTHTTTHHNTNBHNNNBNNNNNTNTNTTNNTNNNNBNHHN
BNNBTTNNTNNTNHNNTHTHNNNBHNHTNHTTHNTNBTTNNBTNBBHNTHHTHNHNNNTNNBNNHNNHNHHNNBNNTNNNNNBHNNNHNNNNNNHTTNNT
TNNNNNNTHTNTTBHHNTTTNHTHNNBNNTNNNNNTNNTNBHNTHNNNHBNHNTHTBTNHBNNNHNHTTNHHHNNHNNHBHNNNHTBHHNTNNNNNHNHT
NNNHNNBTNTHTBNTHHTNNHNHNNNNNTTNNHNBNHBHNTNNNNNNHNNNTNTNNNNTHNNHNHBNHNHHNTNNTHNHNTHTNNNNNNNTNNNNNHNNB
TTNNNTNNTNNNNHBTNNNNNHBNNHNNNNBHHHNNNHTBNTNBTNNNTNBHTNHNBNBNTTNHNTHNNNHHBHNHNNHHBNBHTBNNNTHNNBHNNBHN
BNNNNTHHHBNNTNTNBHTBTBTHNNNBNTHNNTBNTNNNNHTHHTNTNNNTNNNTBNTHTNNNTNNNHNHNBNNNTNNNTNHHTTHNNTTNBNHHHTNH
TBNTNHNTBNNHHTNTHTTNBHHNBBTTTHHNHTTNBTNNBTTTBHNHNNNBHTBHNBTHNTHNHNTTNHNTTBNNTNTNHTNHHTHHBHNNTTBTTNBN
NNTTTHTHTNNNNTNNNNHBNBNNBTBNNNTHHNNNTNNNHNNNNNNTNNNBTNBNNBTNHNTNNNBNNTNNTNNHTTNTHNNNNTHNTHBTNTBHTNNN
NHNNTNHNBNHNTNHBNNBNHTTNBHHNHHTNTNNNHTNNHTBNNNNTNTNHNTTNNTNNTHNNHBNNTNNTNNNNNNNTBNNTTTBNTTNHNHBTBNNN
NTBHNNHNNNNNTNHBBNTNNBNTHHHHBTNHHNNNTNTTHHHHHNTNHHNTNBNTTNNTHNBBNTNHTNNNBNHHNNNNNNTNNNTTNBNNNNNNTNNN
TNTTNBNTNBBTNNNNBTBBTNBNNTBNNNNHTTTHHNNNHNNTTHHHNHHBNTNNTNTBTTNHHHHNNNBNBNHNNHNTNHHNTNNHTHNNBBNHHHBH
TTNHTNNNNTNNNNHTNTNTHNNNHHNNNHHNNHNHNNNBTNHNHBHBNTNHNNNTTNTBBHNTHTNNNTTNHHNHHHNNNNNNNBNHNNNNNTBTTBTB
NNHHBHNNHHNNNNHNNBNNNTBTNTTTTNNTNNNBNTHHNNNNNNNTNHNTBTTNNNHHBNNNTNNNTNNNNNBNNTTHHTNHNHTHHNNNTNNTNNTB
HHNNHBHNNNBHNTNBNNTNBNHNHNNHHHNNNNNNTTTBBNNNHNNTNTHNNHNNHNTTNNTTNNNHNBTNHHBHBBNNNNNTNBNTHNHNNNTNBTBN
HTNHNHTHTHNBHBHTTTTNTTNTTNNTNNTNNNTTNNNHBHBNNBNNHNHBNBTNHHHHHNNTTNTNNTHHNNHNBNTTNNNNNNNNBTHNNNNNNTTN
NNBNHNTBNHHHTNHNTNTHBHHNHNNTHNNBTNNNNHHBTNHHHNHNNTHNBNBHHTHHTHNHTTNNNHNHHNNHNNTNNNHBNTNTNBBNNNHHNBNN
HNNHNBHHTTBNTHTNNNNHHNHBTNNNNHHTHNNTHNNNHBTHNHTTTTHNNNNNNNNNNNTNHNBNBNNNNNBNNNBHNNNTTNTNNBNHNHTNTNBT
BNTNBHBNNBBNNHNNTTHBNNTNNHHNNTNBHTHTNNNHNHTNBTHHNHTNHHTNNHHHNBTTHNTNNTNNHNNNNNHHNNHNNNTNNNBNNNNHNHBN
BHTHNNNHNTTBNNNBNNBNNNNNNNNTNTNNHTNNBBBNNHNNHBHNTTBHNNNHNHNNBTBBNNBNNNTTHHNHTNNNBNNHHNBBBNHTNNBNNHNN
NNHNNNNNNNTNHNNNTTBTNBHHHNNNHBBNNNTTHNNHHNHHTBTBTNNTHHNTHTNBTNHNNNBHNNNNNNTTNNHNNNNBNTHNHNNNHHNBNTHT
BNNHHNTNHNNNTHBHHHNBHHNHTBBNNTBHNNNNNBNNBHNNBTNNNHNHHTNNHNNNNHNNNHNTNNTNNNBNBHNNNNBNNNBNNNNNNNHHNNNN
NHTHHBNNBTNNTBNNNBHNHTNTNNHHNTNHHNBNBNBNHHNHNTNHHTNTNHNNBNNNNHTTNBTTBHNTNNNBHNNNTNTBHNTNNNBNTTBNNNHN
NHNNTTTBNNNNTNNTNTHHTTTNHHHNBNTNTHBNTHNNHTNTTTNNNHTNHBHTBHHNTNNHNHHTNNBNNNHHBNBNTNNNHTTNTTBNNBHTNHHB
THNNBTTNTNTTNNHBNNTBTNTBTHTNHBTBTTNNTNNHNTBHNHNHBNTTHBHNHNNNNTNHNNNNTBHTTNTTNNNNNNNNTNNNHNNHNHTNHTHN
TTNNNNHTHNNNHTNNTNNTNNTTHHHTNNTTNNBNNTTHNHHNNTTBTNNTHTTTHBNNHNBNNNTNNNNNTBBNHTHHHTTNNNBTHNNTNHNTBNBN
TNNHNTTTTHHTTTNTHHBNNNNHHNHHHNHNNNHNNNNHNTNTNHNNHNHNTHTHTBNHNNHNNNNNNTNNHBTHHNTHNBNBHNNNNNHNNNNTNNBN
BTNNTHBTBBNNNNTBNNNNNNNHNHNNNNNHNNHNTHHNNNHNHNHNNNTTNHTNNNHTNHTHHNBTHBTTBBHTTBTNHNTNBNNNHNNTNTHNHHNH
TTNHBNHHHNHNNNNNNHBNHNNHNNNHNTHNNNNNNNTNHHTNNTHHNNHBNHNNNNHNNHNTTBNNTNNTNTTBHBNTNTNNTNNNBTTHHTHNBNTN
BHTHTHNHBNTNNHNHNNNNHHNTNHHTNNTNNHHNNNBTTNNHNNTNNBTTNTNTNHHTNNNNNNTHHHBHNNBNTNHNNNNBNHHTBNTBNNBTNNHN
NTTNNNNNTNBNNNNNNHHNNTNTNBNNNHNNHNNTNNHNNNHNTNHHBNNNHNTNTNBHNNHNBBTNHTTHBTTNTHTHNHHHNBNNNNTNBNNHHBNN
HHNNNNNNNNNNNNNNBNBHNHBNNNHHNNTTNTTNHHNHTNNNNNTNHNNNNNNNNNNTBNNNNNNNTNTNNNTHNNHNTHHNTNTNNHNTTHNBTNNT
NTNHNHHHNBHNNHHTNNHTTNHHTNNTTNNHHHNNNHHNHNNNHHHNHTHNNNHNNHTHTNNNBTHNNNHNNNNNBTTTNBNNTNTNHHTHTNNNNNTH
NNHNNNTBHNBNHBHNTNNHNHBHNNHNNNNBNNTNBNHTHNHTNNBTTTBTTNNNNNNNTBTNNNHBNTHNTTNTHHHTTTNTNBNNNHHBTTNHNNHN
NHTHNBHNHNNHNHNTNTNNHHBNBHBNNTNNNNNBNHHNHTNNTNNHNTHBNNNHNNNHTTTHHTHNBBNHNNTNBNTHHNNTNNNBNBTNTNNBTBNB
NNBTNNHNNNBHBTNHNNHHHTHBBHNHHNNNHTNTTTHNTTNNBHNNNNNTTNHTNNNNTNNTHNNTHBNTNNNTNNBNHHNTNNNBBNNNNNNNBTTN
TNNNTBNNNNTTBTNNNNBNTTTNNNNHBBTTTTNBTNNNHTTNTNBBNNTTTNHTNHNHNBNTTHNBNHNBNTHTTTNBTTHHHBTNTNTNTTHTNHHN
TNTNNNHNNHTNBNNNNBNNNTHNTNHTNHHNHNNNNHNNNTNHTHNTBNNBHHTTTTHBHNNNTBNBNBNBHTHNNNNHNNNHTHTNNNHNHHNBNBNN
NHBNNHNNTBHNHTHNNNNNNTHNNHNNNNTHNNTNNNBHHNHNBBNNNNNBBTNNNNNTHNNBTNBHHNNTNTHNHBBNNNTNBHTTNNHNNBNNNBTN
NTNBTNNHNTNHNNBHNHTNNNBNNTNNNNHNBNNNBTTTTNNNNHHHHBBNHNNBTBNNNHNHHNNBTHNNNHBNNTHHTNHNNNNNNNNTNTNNHNHN
TTHNHHNNBTNNTHNNBHTNHNHNNBTTTBNNHBNBNHNTHTNBNTNBBHNHTNTNHNNNHNNNTTNHTTHTNTNNNHNTTNHBNBNNBNNTNNHNNNNN
TTNTTNNNNHNBNHNNNHTTHNNHTNTNHHHBTTNNBBNNNNNTNTNHNTNNNNNNNHNTNNHNTNHHTTHBNBNNNNNHTNHHNHNTNBNNNHTNTBTH
NHNHBNNTTNHTHNNNNNNTNTBBTNNNNTNBBBHHNTTHHNNHNNHNHNNTNHBNHNTTTNNNNNTTNNHNNNNHHNBTNNTTNTNTHNHNHNBTHHBT
NTNTTNHNTNNNNNNNNTNNNTTNTNNBHNNNHTNNNTNTNNNHTTNNTTHNHNHHHBNNNHNBNHBNNNTBNHHNNNHNNHNNNBNNBNNTNTNTNHBH
TNNNTTTTNNHNNHHHBNHTTNTNTHNNHNBHNTTNBHHNHNNBHTNNNNNNHNHNNTNNNNBTNNNNHNNNNHHNNNTHNTNNNTNNNNTTNNBTBHHN
BNHNTNTBBNHTNBNNNNNTNNBTNHNTNTNNNHTNNHNHNNNNNNHTTNNNNNNNNHNHTHNHNNHTHHBHHTNNTTHHBHNHNTNNNHNNHNNNTTTN
NNTTNTHHNNNBNHNNHTTNBNHTNNNNNNNNNTTHNTBBHHNTHNNTTNNNNHNNTHNHNNHBNHNNTTTHTNNNTNBTBTNNNHTNHTNNNBNNNBHN
HNHTBHTHBNNTTTHNNNNNNNNBNNTHNNNTNNBNNHNNTTNNNNHBTHTNNHTNHTNHNNNNNTTNNTNHTNNNNHHHTHHHHNNNNNNNTHBNHNNN
HNNNHNNBNNNNNNNNNBNNHHTTNNHTNHTHHHNNHNNNNNTNNHBHNHTNNTNTNHHTTNNNTBBNTBTTNNNTBNHNNNTBBNHTTTNHBNNTTHHH
TNNNNHBNTHNNNNNTTHTNTNTNHNHHTTNTHNNTTBNNNHNNNBTNNNTBBHNTHNTTNTNHNNBTNNTTBTTBNNNNBHTTBNHNBNNNNNTNNTTB
TNTNNTTNTNTNTTNHNNBHBHHNTTNNHBNNNHNHTNTBBNNNHBTHHNNNBTTNBNBNNNHHBNNHHNTNBNHNNTNHTNNTBNBNNHTNTBNNHTTH
BHNNBTBHHBTBNNBHTNTNTNNNNHTHHTNBTNNTTNHBNBNTTNNNNTNNNNTNTNTHHNNNBNTHBNBNHBHNNNNNHNNNHNNNTNNNBNHNTHTN
BNBNHNNBNNNTNNHTNNTNBHNNBTNNHNTHTBBTBNTHBTNNTNNBHHNNHHTNNTNNNNHNNNTNNNBHTHTNTHTNNNTHTNBNHNHTNNNNTHHN
TBHNNNNNNBNHNTBTHHTNNTHNNTNTNNTHNBNHHBNTTNNTNBHNTBTTHBNHTNBTHHHNHNHNHHBHNBBTNHNHNNBHNHHBTNTTNBNTTNBH
THNBNNHNNNNHHTTNNNTTNNTTHTTNNNNNNTNTNNNNNBNNHTBNNNNTBNNNNBHHHNTNBBTBBBTHNHHHNTHNNNNNNNTNHHTNNNNNNNTT
NNTBNHNNHBHBTNBTTNNTNNTBBHNTNHTNNHTNTBNHNNNNNNTHNHTNHNBNNBNBNNBBNTNNNTNBNNTHTTTNTBTHHNTNBTHNNNBNNNNH
NBNHNBNNNNTNTHHBTNTTNNTTNNTHHBTNNBTNBTNTTHHBNTNTBNTBNNTNNNNHNHHNNNHNHNHNTTNHNTNHNBHBNNNTNTBHNTNHNNTH
TNHHTTNNNNNTNBBBNNNHTNNTNNNNNNNHNTNNNHNNNNNNNNNHHTNNBNHHNTTNHNNNNNNBTNNNTTBNTHHTNTNTNTHTNNHNHTHNNNTN
HNTBNHTTNHNBHTBHNNNNNHHTTTHNNNNNTNNTNTTTNNHHNHTHTHTNNHNNNBNNBTBNNBTNNNNHNNNHNTNNNNNTNBTBNNNHNTTHTHNN
BNHBNHNTNBNHTBNNTHTBBNHNBNTNNHNNNNBNNBHNHBHTNNTNNHTTTNHNTNTTHTHHBNNHBNNTBHNNNNNNTBNNNTHTNHNNHNNNTNHN
TNTTHNTNNHBNTHBNHBNHNTTNNHHNNHHNNHNNNNTNNNNTNTBNHHHHHTNNBTNNNHBBBHTTBNHNNNTHTTTNTNNBTNNNNBHNNNTNTHNH
NNNHNNNHHNTNHHHBTBHNHNNNNNHHTNNNBHTHBNTNHTNNTTNNTTNHNNNNBNBHTNHTNHNHNHNNNHNHHHNNNNBNTHNTNNNHTHHTNNBN
HBHHTTHNNNNNHBNNHHNBTTHNHNTTBHNNNBNNTTNTNNBNNTNNNNNNTTNBBNNTHHHTHNHNNHTHNNNNNHNNNBNNNNNTNHBNNNBNNHHN
HNHHHNHNNNTNHBHTHHBTNHNNNBNNNHNNHNHHHNHBNBNTHNNNHHHTTHNNHNBNNHHBHTTHNNBNNTTTNNNTBTNNNNNBNBHBNBNTNNBB
NNNBNNNHNNNNBNHNHHTHTTNBNNTNBNNNNNNNTNNHBBNNNNNTNHNBBNNTNHHHHNBNHHHNNHNNNNBHTNNHNNNTNNNHNNTNNNTTTNHH
BHHNTBTTNTNHTHHNHTNHHNNNNNNBNHNNTHTHBHTNNNTNNTBHTNHNTNHNNNHNTNNNTNHBHTTBNBNNBTTNNNTNHTNTNNHTHNTHNNNN
NTBNNBTHNNHBBTBBNNTTHNHHHTHBHNHNHNNNTTNHHNNNTTNHBNNHNTHNNHNNBHBNTBNNHHNHTNNTNHNBNBHTNNBTBNNNTNNHBNNN
TNNNNNHNNHHBNNNTNTNNBNTTNHBNNNNBHNNNTTHNNHHHNNHHHBNNBHTHNNBBHNHNBNNNNNTHTBTTNBHBNNTHHHTNBNNBNNNHNNHH
NNNHNNTNHNNHTBNHNBHNHNBTHHTNTNTTTNNTTTNNTTNNHBNNHBHNNNBBTNHNNNTTNTNTBNNNNNNTTNNTNNNNTNNBHNNTBNNNTNTB
NTHNTTNNHNBNHTTHTNNTNNNBHNHNNNNNNHNBTNNHHNBNNNNNNTNBBBHHNNNNHNHNBTBNNNNTTNNNNNHHHNHBBTNBNBHNHNNNHHNB
NNNTBNBBNTNHHNTNNNTTBNNHBHNBNBNTHNHBHTNNNTTTBNNBHTTBBNNNBNNNHNHNNHNNBNNHNTNHTNBHHNNNNNNTNHHNNNTTTNNN
HHHTHBBNTNNTNNTNHNNHTNBTNHNNBTNNNHNNTHNHNNBHTHTHHHNTBNBNNHNNNHNHBHBNNTTBTHNNNHHNTHTHHTBTTHHTNTHNTNHN
NNNTNHNNHBHHHHNNHNNTHNNNTNHBNTTNNTHNNBBBNTHNNHHNHNTHTNNNBHNHTNTHHHBTNNHHNNHNNNHHNNNNNHHNHNHNNNHNNHNN
NNTNNNHNHHHNNNHNHNTNNNNTBNNTNNTTBTTHNTNNBHBNNNHTBNTNNNHNNHNNNNTHTNNNNBBNNNBNTTHNNHNBBNNBNTTNTNNNHNNN
NHNNNTHBHHHTNNNNHHHNHNNNNNNNNTHNBNNHNNHNBNNNNNNHHHNTNTTNNNNHNHNNNHNBNNNBNNNNTTNHNHNTNTTNNNNNNNNTNNNN
HTNNHNTTBNTTNNNHNNTHTNNTNNNTNNHNTHNNNNNTBTNTTNNHNHNBNNTNNBNNNTNNNHHNNHHHNNTNHNTHNNBNNTNBNNTNTNTHNHNT
HNHNBNTNNNTNHNNTBBNTTBHNHNHTNTNNTNNHBNTHNTNHNTBTNHNBNHBHNNTHBTTBTNNNBHTNTNTNTNNNBHTNNHNBNNNNNBBBTNHT
HHNTNTHNBHTNNNBNNNNNTNNTHNNNNNTNHTNNHTNTNBTHTBHNBNTHNNNHNHNTHNNTNTBBNTNTNBNHNTTNNNTNNBHBBBNHTNHNHNHN
NTNHNHHHNTNBHTTBNBNBNTNNHNTBNHTHHNNNBNNNNNNHNHBNNTTTNHNNTNNHHBHNNNNNNHNNHHNNTHHTNTNNHTNBTNHHTTNNNNNT
HTTNNTNBBNTNNHBTNNHHHNNNTNNTNTHTHNNNNTNNBNNHNNNNHHBTBTNHNNBNTNHBNNTNNNNNHTNNTTHNNNNNTNNNHBHNTBNNNHNN
TNHBTNTHBNHNNNTTNHHTTNHNNNNTNNHNTNTBNNBNNNNNNTBHTTHTBTNNNNBBHBHNHNNNHNBTNHHNTNNBBNBNHTTNNNNNBNNNBNNH
HHNTNBTNTHHHNTHTTNHHNTTNHBTHHNHBNNBNNNTHTHTNTTNNBNHNHNTNNHNHTHHNNNBTHHNNTNBNTHHTNHHNBNNTTNNHNNHHHNNT
HNNNNNNNNHTBNNNTNNNTTBNHNNTNHHNNHBTNNNTHNNNNNBHNTNNNNBNTHTNNNNHTHHHNNHNTNHTBTNTHBTBTTNHNTNTBNHHHHHNH
NNTNHTNNTNNHHNNTTNNNNNNNNTNHHHHBHTNNHTHNHHNBTBHNNHNHNNHNHNNNNNHNNHNNNNNNNTTTNHHNBNNNTNTNNNNNNTBNHBNT
TNNNNTTBHBTNHBHNNNNHTNHNNNNNTNHNNNNNNTTNHBNNBTBTNNHNHNNNNHTTTNNNHNHNHNHHHNHNNNNNHHHHNNNTNHNNTNTNNHNN
NHHNHNNNHTTNHNNBHBHNNBTTTNNNBNNTHNHNNTHHTNNNTNNHBNHNNNTNTNTTTTBHNHHNBBNHHNBNHHNHNNHTBTNNNHNHNBNBBBNN
NNNTNHNHTNNHNNNNBBTTNHNTNNTNTNNBNNTTNHNHNTNTTNNNTNTNNTHTNNHNTTTNNTHBTHTNNNNNNNNBTTHTNHTNNBNHHBTTNNNN
BHHNTNTBHNHNTTNTNTBNBHTNNTNNTTBNTNTNTNNNHNTNTNTBNTHTNHTHTHHNHNNBHNHNNTHBNNBHNNHBNTNNNNHNTBNHNBTBTHTB
NTHHNNNNHNNNNTNNNHNBHNHNHNNBHNHHBTTNTHTHBHHHBNHTNHHNNNNNHNNTTNHNNNNTTNNTNTHNTNNHNHNBHNNHBHHTNNNTBNBH
TTHTNBTHNNNBBNNTTTNTNHNHNHNTNNNHTHNNHHBNTNNTTHHNNNNNHHNHBNTNNTTNBNNTNNBTNNNNHHNBNNNHHNBNNHHNNNHTNNNN
