BHNNHHNBNNNNNNTNNNNTTNHNNTNNNNTHTNBNNNNNNBNHNNNBHNTNNNNNTNTBNHNBNNNTTTTNNHNHNBNTTNHHNNNHNHTTNNNNNTTN
THNHHNTNBNTNNBNTNBNNNBTBNNHNNNNNBNNHNHNHNNNHNNBNNTHNHTNNNNTNNHBHBHTNHNHTNTTNNBNNBTNTTTNTNNHNNNNHNNBH
NTTNNNTNBNBNHNNNNHNHTHNNHTNNTNNNHNNTBBNNBNNHTTNBTNBNNNTTTNNNNHNNHNNNNTNNNBTHNNNHNTNHHNTNNBHNNNBNNBHN
NTNNNTTNNNHHNHNHHBNTHHNNTNNBBNNHNHNNHNHNHNHNNNTBNTNBHTHTNTNTNTBTNNBNHBNTNNTBTHTNTNHNNNNHNNHNHBTTBBBN
NBNTHHTBTNNBNTHHNBNNHNTNNNBNHNNTNHNBTBNNNNTNNNNHNTNHTHHTNNHNNTBHNHNTNNBNNNNHTTNNNNNHNTNNNNHNTHNNNHNT
NNNBNTNNNNBHBBBTHNTNNBTNTHHNNNNHTBNTTNNNNHHNNNNTBBNNNHHNNNHHNNTHHHNHHNHTBHNTBHNNNNNNNNNHTHTNNNTNNTNN
TNNTTNBNNNHNTNTHNNTTNHNHTNHNNNNNNTNNNHNNTNHTHHNNNNNHHBBNNNBTTHBNNNHNNNTNNNNNHNBBBNHNBTHNNHNNBNBTNBNN
BNHBHTNNNBTNTNBTNNNHHBTTHTBHTHTNHTNNTNNTTNBTNNNHHBNBNBNTTTNNNNTNNNTNNHHNBTBNNNBHNTBNNNTHNHHNNNNTNHTT
TNNNHHHHBNBNNNNTTNTNHNTNBNNTNTNHNNNNNNNNNNBBNNTNTHTNTNNHBBNHNTNTNNNTHNHHNTNNNNBNHTNNTNNHNBNTNNBTTTNH
TNNTTNTTBBTTNHNHNNBNNNTHBNBTNNHTBNNNNNTNNTNNTNBHNHNNTNNNHNNNHHNHNHTNNTHNNTNTBHNNNNNBNNHNHHHHBHNNTNHN
HTNHNTTNTNNTNNNNHHNNNNNNNHNNTNBTNHHNNHTTHNTHNNBNNBTHNNTNNTNHNNNNNNTHHNNHNHHBNBNNNNNBHNNNNNHBNNBTTNNB
TNTBNNNNNHNTNNTTTNBBNHBNTNHHNTNHNTTHNTNTTNHTNHNHNNNNNTHHNBNNNNNNNNNHNTNNNNNNNTNNHTNTHTNNTNHHNTNNNHNT
NHNTNHTHNBBBNNNBHNNTNTNNNBNNNHNNHTHTBTNTBNNNHNHHTTNNNNTNNHBNNNHNNBBNTNBNBTHBBNTNNTNNTHHNBNNTNTNTNTNN
HHNHNTNTNBNNTNNTBBHNNNBBTNNNBTTNHNHBNTHTNTBBHNNBHTHHNHHHTNNBNTTBNHNNNNNBNNNNNHNNNNNBNTTHNBNNTNBHTNNB
NHHNNTNNTBHNHBNNTNHHBTTHNTHTTHNHHHHTHBNTNNNTHBBHNNNHBTNNHTTNHHHBHNBTNNNHTNNHTTHNNNBTNNNBNTBNTHHTTNNN
NNHHNNHTNNBBTTBNNTNNNTHTTNTNTNNTNNHNNHTNNBNNTNTTNNTBNBHNHTNHNHTNNHNHNNNHHNNTBHHTNNNNNNTNNTNBNNBNNNHN
NNTTNBHNHNNTBHHNNNTNNHTTNHHHTNTTTNHHNHTTNNBNNNTNHNTTNBNBNNHBNNNNNTNHHHTNHNNNNHBNHTBHNNNTTNNBNNTNHTNH
TTNHTNNNHNNNNNNNNTTTNNTBNNTNHHNNHTNNNTTNHNNHNTNNNNHHNBNHBHNNTTTTNNTTHHTNTTHNNNTTTHHNBTTTNNHTHNHTNHNN
NNBNTNTNHNNTNTNNTNNNNHBNNNNHNTHNNTTNNNTBNNNNTNNNNNHBNNTHHTNTTHBBTTNHBHNNTNHHNNTNNNNTNNBNNNNNNNHTBHNB
TNNHNTHNHNTHHHHNNHNTNTHNNHBNNNNHBTBNNNBNTTTNNNBNHNHNNBTHNBNHNNTTNNHTNNBNNTTNNNTNHBTNNHNNBNTNNNBHHBNN
NNHNNTHNNNNBHTTNBHNNNHNHTNNNHNHTTBTNHNNBNNBTNNBNBTHNNBTHNNHBHBBNBNTHNTTNTNNNNNTTNNNHTNNHHNNNHNNNNNHN
HHNNNNHBBHNNTBTHNTTNHNNNNHHHHNHTNNNNNNTNNNBNNNBNNTTNHNNNTNTTBTNNTNHNNTNTHBTBHNNNNNNNHHNNNHBNNNNNNNNH
NNNBNHHHTHTHHNNTNNNBNHNNNHNNNNBNTTNNNTTNTHHTBBNNNHNBNHBNHNNNHNNHTNTNHNHTBNTNTHNNTNNHTNNNNNNTNBNNHHTN
NTNNBBHNHNTHTBNNHNHNNTTNNNNHHNNNNNHBBNHHTNHNBNNNHNTTTNNNTTHTBNNTHNBNBHTHTHTTNTNNTTNHHNNHTNNNNNNNNNTN
NHBTNNBTTNBNHNTBHNHTTNNNNNBBBNTNTHNTNTNTHNNHHBNTHNHNHNTHNHNNTNNHHHNHBNNNTNNNNNBTHTBBTNBNHTHTTTHNNNNT
NNNHHTNNHNTNHNNHNHHNNHNNBTNNNNNNNNNNNNTTNNNTNBNTTNNHNNTNTNHTTNTTBBNNNNTHNNBTHNNNNNHHNHNNHTNBBNHNBTNT
HTNBTHNNNHNHNHBNBBBTNBTHNTNNHNHNHBNHTTNTHHNNNHHBTBHNNNNNTBNNTNHNHTNTBTHNNNNNNTHNNNTBHTHHHNNBNNHTNNNT
NNNNNNHNTNTTTTNNNNHNHNNTTHBNBNNNNHTTTNBNNHNHHTTNNNHNBBNNTTTTNNNBTBNNNHNNNTTNNNBBBHNTBBHTNTNHHNNNNNTT
BNTHNTBHNBTNTHTHNTHNNNTBNNHHNNHNNTNHTNHTTBNNHNHHNNNNTNNNHHNNNTHNNHNTNHBTNTHBBNHHNTNNTNNNNNHNNHHNNNNN
BNNTNNNTHHNBNTNTNBNBTBTHHNHNBHNHHHTTTHNHBTNNNBHNNTNTNTNHNTNHNTTTTHTNNNBNHNNBTTTNTNHHBNTHTBHHHNNNHTHT
NHTNNHTNBNNNBTNTHBNTNNBBHNNHNNNNNNNNNBNNHTNNNHNHNTHNNNHNNTBHHHNNNHNNBNBNNHTNNNTNNNNTNNHNNNNNTNNNBHNB
NBNBBHBHBNNTTBNTNHNNNHBNNNNTNBHHHNNNNTNTNNHNHTTTTBHTHTTHNTHTNNNTNNNNNHNHNBNHHNNHTNBTNNNBHNHTHNTHHTHN
HHNNTNNNBHNNNNNNBHBTBHNHNNHHHNTNHNNNTBTHBNNNNNNNNTNNTHNNBNNNNHNHNBTTNNNTNNHNNTNHNTNNTNHNNNNNTNHTNNHN
BHBNNNTHNHNNHHNNBTBTBNNBNNHNTHNTTNTBNNBBBNNTNTNBHBNBNNNNNTNNNBTNTNTHHTTBNHNNNNTNBNNTHNNNNHNTNTNNNNBN
NTNHNNNNHBBNBNHNNTHTBHTNTNBNNNNNNNHNNBHTNTTTBNHTHHHNNTHBNNHNNTHTHTHNNTHTHTHHNTNHHTNBNNNNTBNNHNNHNNNT
NNTNHNNNNNNHNNNHNNNTNBTNNTTNBNNBNTHHTTNBNNNNNBNNHTHNHNNTHHNTTNHTHNNBTNBNHTTNNTNNNBHNNHHNNTNHBHHNTBTH
NNTNHNHNTNNTHNNNHTTHBHNHNHNNTTTNNNNNTHNHHNHTNNNNNHNNNHHNHHHTBHTTHNNNHTTNBTHHNHNHHBNNNHNTTHNNNNBNHNNN
THTNHNTTNHTBNHTHNTNTNNTNBNNHTNTHTBNHTTNHHBTNHNNHHHBNNTNNTTNHNTNNHNNNTHTHHTNBHHNBNTBNTTHHNNBNNTTNNBNN
BNTHNNNNNNHTNHNNNNNHTNNHNNNHTHHNNTTNNNNHHNNNHNBHNTNNNTNNNTNTNNNNNNNHNNNHBNBNBHBNTBTNNTNNNTNBNTTTNHHN
TTNNHHNHHBTTBBHNHBBNNTNTTHNTNTBNHTTBNNNNHBNTNHNTHHNNBNNNTNNNHHNNHHNNNNNTBNNBNTNNNBNNHHTNTNNNHNNNNBTH
NNTNBNTTTNHTNBNNNBHNTNNTNNTHHHNNNTNHTHNBNHNNHBHNNNNNTBNNTNTNHNNBNTNNNNTHBNTNNBTNNHBBTTNNNNNHHNNNTNNN
NNNTNTNNNTHNTNNNNNNNNTBTNTBNHNHHNNTNTTNTHNNBHHBNHNHNNHHHNTNTTNNHNTNNNHTBTNNNNNHNNNTNTNNHTNHTTNHBTNNN
BHNHNTTHBTNHHNNNBHNNNTNNNHBNNNTHTHNHTHNNHNTNBHHTNHNNBNNNTNNTNHHHHNNHNNBHHTBNNNHNNNNNBNNNNNHNTHNNNHBT
NTNNNTTNNNNNNTTHNNHHBNNNNNTNNBNTNTHNNHNTNNHTHBHTNTNNBTTNHHHNTNHTBBHHHHBBHNHNBNNHNTNNNNHNTTBTHTTNNTTN
TTNTTNHNNBTNTNHTNTNNNHNTNTHNNNHHTNNHHTHNNHHHNBTBBTTNNNNBHBBBTTNNHTNBHBTTNHBHNNNTTNHNNTBHNNTTHNHHNBNN
TTNNHTNTNNNNTNHNBHTHNNHBHTNNHNNNNNHNNTTNHTNNHNNNHTBTHHNNHTNTNNNBTTTNNNNNNNBHNNNBTNTNHHNTNNHHTHTNHNNB
BNBNHNNTTNNNTTHNHNNNTHTNHBBNBNHNTNTHTBBNTHTNTNHTBBTHBTHHNNHNNHNHHNNNNNHHNBNNNNHHBTNTHTNTTNNBBTNTNNNN
NNNNNNNNNTHNNBNTNNNHHNHTNBNBNTNNNNHHNNNNBNNNNBNNTNNHHHTBNBNTHNNTTNTHNNNBTNBNHTNTTHNBTNTNTTHNNNNNNNNN
TBNTHNNNTNTNBBNNTNNTNNNTNNNNBNHNBNTHTNHNNNNHHNTHBNNHHNBTNNTTNHHTNNHTNHNBBHBHNTNNNBNNNHHHBTNNHNTNHNHN
NTNHTTNHNBHTTNNHTHNTNHNHNTNTNTNTNTTBNNTNNNNNNTNTNBNNTTTNNNNTTHNHNNTNTHHNTBNBBNTNBTBNHTHHNHHNNTNNHNNT
NNTHHBHNNHTNBNNNNBBNNHNTNTNHNNHNNNHNNNNBHTNNTTNNNTNHTBHBTNNNHHNNTNTNNBNNTNTNTNHNTNTHHTBNHTHNHNNNNNHN
HTNNTNNBHNNNTNNNTHHBTNHNNHNNNTHNHHNNNBTTNHTHNTHTNBTTTBNNNNNHNTTHNNNNTNNHHTHBNNHTHNNNNTNNHTNTNTNTHHTH
NNTBNNTNNNTNTBNNBBNHHNTNHNTNNHTBNNHNTNHNNTTTBNBHNHBTNHNNNNNNHHHTHHTTNBBNNBHNNBNBBNTNHHNNNHBNNNNNHHNH
NHHNNNNHHTNNNNNNHHNTNHTNNNTNNNNNNNNTHHBNTNNNBNHNNHHHNNNHHBNBNNNBNNNNHNNNNNNTBTNNBNNNNTHHNBNNBNHBNNNT
HNNHHNBTTNNTNNHNHBTHHNTTNNNNNTHHHHNNTTHNNNHHBTNHNHTNHNBNNNNBTTTHBNHBNTNTHNNHNHTNHHNNNNHTHNNNNTTBBNNH
HNTNHNTNNNTNHHTTNNNNTHNHNNNNNNBNBNTBTHHNNHHHHNHHBHNNNBHNTTNNTNTTHNNNTHNNBNNNNTHTHNNNTNTBNNNTHHTTTTNH
NTNTHTNTHBNBHHBBNBBNNNNHNTTNHHBNTTBBTNNBHNTNTBHNHTHTHTHHBNHNNBNNNTTHBTHHNNNHBHTNNBNNNNBNBTHNHTNNTNTN
NNNHNNNNTNHNBBNNHNHHBNNNNNTNTTNHNNNNNBNNNHNTBHNNHNBBNHNNNNNNNNBHNHBNBNTNNBBBNTTNHTBNNNTNNTHNNBHTNNNH
NTTNNHTNNTTBTNTHTNNBHHBNNHNNNTNNTNNNNHNNHNNHBBNTHBTHHNNNNNNHNTBHNNTHNNNBNNHNNNTHBNHNNBHNHNTNHNNHNBTB
TTHNTNHNNNNTNHHNTTTTHNBHNNNTNNNNNNBTTHNBNNTTTHNNHHNHTHTNNNNNNTHNNNNTHNHHNNNHNNNTTNNNHNTNNNNNBNNNHTNN
TNNHTBNNHHNTNNTNHHTBTNNNTHNBHHNBBNTNNHNNNTBHNHHTNNNNTHTNNNNNTNHNHNHHNTNBTNNTTBBNNNTHNHNNTBNTTNNNHNNH
NNBTTHTHNNNNTHTBNBNNNHNNHNNHHNNBBBNNTTNHBHHTTNBHNNNNNNNNBNTHNNTHNNHNNNHNTTBHBTNNNHNHTTTTNHNTTHBTHNBN
THNNHHNNBNBNHNNNNTNNBNTHNBTNNHTHNTHNTHNTNHTNHNNNNTNNHNNHNNHNNHNNTNHHHHNNNNNBNHBHHTNNHBHTNHTHNNNBHHBH
NNNNNNNTNTNNNNNTNNNTBHBTNNBNNNTBNTTTHNNNHTNHNHHTNTNNBNHNNTNBNBNBNNNBNNBNHNHNNNHBTHBNNHBTHBNNNHNNNNHN
NBNNNBHNNTTHHTTBNNTNNNNNNNNBNNTTNTNTNNNBNNBNHHTTNTHHNNTNNTTNNNTTNNNNNNTHHNTNNTBNNNNNTNHNTNNNNTTBTHNH
TTBNNTNTNNTNNTHTNBTHBTTTTHNTNNTNHTNBNTNNNTHNNHNNNTNNNNHNTHNBTNNNNHNTNNNNNNNTNNHHBNNNHHTBNBNHNTBNTHNT
TNHNTHNTNNNTHTNNHTHHNNNBNNHNNHNNNNNBNHHNHNBNBBTBNNNHHTBHHNNTHNNTHHHNNTHNHTHNBHNHNBTHNTHHHHNTNHNTNNTN
NNNHNHNTNHHBNNTNHTHBNTNNNNNHTNTHHNNBBTNHHNTTNNNHNHNNNTNNNTHTHBNNNNNTHBHTNHNNHNNHHNHTNNNNNHNTTHNBBNNN
NHNHNNTBHNTHNTNHNHHNNBBNNNBNNHNTTNNHNNBHNNBNBBHNHHHHHNNNHNHNNNTNTBTHNNTTTHTHNTHNHHNTNHNHNNNNNNNNNNNT
NTNTNTNTHNTTNBHHBTHHNNNNNNTHBNNNBTNTNNNNNTHNTBTTNHNTNBNNBHTHHTNHBBTHNNTBHTTNNNBNNNHTNTNHNNTHNTHTNHNB
NHNBHHHHNNTNNNNNHTNNNNTHTBHNNNNHHNTNNNTNTNTNNHBTTNNTNBTNNTTTNTBTNBHNNNHNNHNNNNHTNHNNNNNTNTNTNTTHHBNN
BNNNNTHNBTNNHNNNTNBTHNTTNNHNTNNNTNTTBTNNNTNHBHHNNNHNTBNTHNNNTTNHNTTBHHNTNHNNHNNBTTNHNBHNBNHNHBTTHBHT
NNNNNNTNNTHBNHHNNHHBNNTHNNNNNNNTNNBNNNHNTTNTTNNNBNHNNTNNHNBNTNNNTNTTNTTNTHNHNHNNNNHTNNNNHNBNNTBNHNNH
NHNNTHBNNNNTBHNTNBNHTNHTBNNHNBNHNNBHNHHTHHTNBTTNNNTTTNNTNTTNNNNNHNHBTBNHNNHHNNNTHNNNNHTHHBTNHNNNTTTN
HNBTNNNNNHHHNNHNBNNHNNNNBNHNNHNNNNTNTHNHNNHNNBNTNTNNBNNNBHTHBNNNTHTNTTNNTHNNNHTNHHTNNTNBNNNNHNNHBHBN
NHTNNNTHTBHTTHBTHNTNNTNNNTNNHNTTNNNNTHNNNHBNNNNNHNNNNHHNNNNNBHHTNHNNTNNHNTNNNNNNTNBHBNTNNTHBHNNNTNNT
NNNNTHNNHNTNNNNTHNNNNNTNBHTNNNTNTNNHNHTNHBNNTHBTNNNHTTTNNTHHTHNNBBNNHNNHNHTBTTBNTHNNHTTHNHNNNNNNHBBN
HNHHNNTNNTTNTHBBBTNTBNNNHNNBNNBNNNTHTNHTNNNNHNHNNNNNHTTNBNNHTHHTBHTBNNNBNHTNNHHHTNNHNNHBNBHTNNHNHNNT
NTBNNNTHHNNNNNNNHBNNNHHNTNNHNHNBNTTBHNTNTNHNNHHHNHNHTNNNNNHNNNNNNNBNNTNNHNNBBHTNNNHHNHTNHHTHNNBNTNBH
NHNBNHNHNNNNNHHNTNTBBTNNNBTTNTBNHTNNNTNBHHTNNTNHNNHNNHTNTNHHNBNNTNNBNNNHBTNNTBNNHNTNNNNNTHNNNTTNBNNN
NBNNNTBTTNTHBTHNNBNHTBHBNHBNNBNNBTNNTNNNHBNNTNBHTNHNTHNNTNTHTHHBTNNBNNNNHNHNBNNNNNHHNNTNTNBTTHTHNNTN
NBTTBNNHNNNNNNHHTNNNNHNTNTTNNNNHHNNNHBNNTNNTNNNBTNHHTBNNNHNHNNNNTNTTTHNNBNTBNTNNNTTNHNHHNNBTNTTTNHNN
NNBNNNBNNHTHNNNNBNHNNHBNNHNNHTBNTTNHNHHNNNNHTHNNNTNBNTHTNTNNNTNNTHHTNNTHNTHNTNHNNHNTHHBTNHNNBBNNHNNT
NNTTTTNNBNHNNBTBBNNTNNNHNHNNBHBTTTNBNNNHTNHHNBNNNTHHTBNBNBHNTTHHTNBHBNTNHHNBBTTTNNNBHHHTNHNNTBHHNNBT
HNTNNTBNNTTHTNNNNNHNNNHNTHTNNNNTHHTNBTHTNNHTHNTNNHNNNNNNNNNTNHNHNBNNNNTTBTTNBNNHNHTNTTTNTNNTNTTNBTBN
NHNNTNNHTTNNTNNTNNNNNTNTTTBHTTHNNNTTHHNTNTNNNTNNNNNHNNNNNNBHNNBNHTNNBNTNNHNHHHNNNNBHNBTNTHNHNTTHNBNT
HNHBNBNHNNNTNNBTNHNHTNNTNTBTNNTBBNNNNHNNHNBTNTHTBNHNNHNHNNNBNNBNNBHNNNHNTBHHNNBNBHHNNBNNTNTNBTNNNNTN
NNNNNNNTNNHHHNHTNNHNTTTNNNNHTNHNNNNHTHTNNHNNHNHHNNHHNTNTTNNBNNNHNNHHHTBNHHNNTHHNTNBTHNTNBNTHTNNNHTNN
NNNNHTBHNNNNNNHHNNNBNHNNNNNNNBHNHNTTNHTNHBNNTNNBTHBNNTNHTNNNNTNBNHNHHNNHNNNHTHHNNNHNNHBNTNNNHTNTHHHN
TNHNNTHBNNTHNNNNNNNHNTNNHHHTHNTNHNNHNBTNNNTNNNTNNBNNNNHHNNNNHNHTNTNBNHTBNTHHHNTNBBNNNNBBHHNHNNTNBHNN
NNNBNBBNHHNNNNTTNNNNNHTTHHNTNBNBTNBTBHNNNTNTNNNBNNTTNNNNHNNHHHNHBHHNTHBNNBNNNNTTNBHNNHNBNNNBHNBNHNNN
NHNBHNNNNBBHNBNHTNNBNHHNNHHTTHNNNBTNNNNHNHBHTNNNHNNNHNNNHNTTHNNHNBNNHBTBHHTNBBTNNNTNNNTHHTHNHHNNHNHH
NNHNHNTHNBNNTTNNNNNHBTNNNHNNNNNBHTBNNNTTNHTNTHTNBNNHNBNNNHNTNNNTHBNTBNNNHBBHNHTNNNNTNHNNNBTNNNHNTNTT
NNNNNNBTNBNHNTHNTNNNNNNNTNNHBNBNNHNHBNHNHHNNHNNBNNHNHNBTNTTNNNNTTHNBNNNTTBHNTHTTNHTNTNNNHNNNBTNNNNTN
NNNTNNNNNHHNNNHBHHTHNNNNNTTNNHNNTHNNNBNTHHNBHHBNHNHHTBHNBTTNBNNBNNNNNNHNNNTNNNNHBNHHNNNTHTNBTHNHNTNB
HBHTNHBNNTNNBHHHTHNNNNNNNTNHHNHHNNNNNTTHNTTNTHNHNTNNBHHNTBBBNNTTTHHNTNTHNNNNBNHTHNNNHTHNHTNNHNHNNNTN
NBNNHHTNBHHHHNNTNTBBBTTTNNHTNBNNBNBHTNNNNHNHHNTHBTNTNTTTNBNTNNNTNNNTNNNNNNNNNNTNBNNNBNNNTBHBBBNTNNNN
NHBNNHNNNTTNNNBNNNNNNBHHBNNBNHHNBTTNHTBTHTTNNBBNNHNNNNNHNTTBNNNBNHNNNHTNHNHTNTTNNNNHNHNNTNNTNHTNNTHT
NNHNNNNTHTNTTNNTTBTBHNNBHHHNBNBHTNTNHNHNTNTNNBTNHHTBNNNNNHTNNNHTNNNTHHHBTNNNTTNNHTNNNNNNBNHHNNNHNNHN
HNTNTNNNHHNNNNNNNNHBTNNHNNNHNNTNNNNHHNHHNTHTTHHNNHHHNNBNHNBNNNTHNBBHTNNNNNHTTNNNTNHNHHNNNHNNBTNTTNHT
