1311111210211013121211011323313131200101110011331211321123313110113011101023021113102121131113113223
1023121113221100120112111011112333311321231321321121311102111112333111111111112332110111113111123122
2121131333111231231101132122121110233200230111111212011211332321111311321111212221212130213123310031
1132100111132132321131112212013320111112123213103310111311133132301213111133311231112121132311113011
0121111121113112011111220311210111133123101303121131110321301122210112213311013111110113110313101302
3121111011233120111221311011122111111113131111311311133111111112331311113310300211230112111110003321
0310201111111320211001221011102211222033222112211031210213111132130011211111131011133211101311212203
2121112112311102111033111101311022111111111111103210131303321231212131211111010301212231203312111311
3111211011311103033231101111231111031311210031012012311111122130121131110021101221112111133211312221
3011211011321310111311301123213121213311111110023111211331311303011331311211133012110131110111112311
1100123030122201113121111311231322113112111133312121102113323331300021213131211212211221131211112333
2102131202131213211211111012231101211121111231231300011123212013111201013312332121313132213310121211
1312311320001111211121023033030111321110210110012111131123111100231120112121102222221132102113221332
1121311220132111333211113211113230131322322220023110231201112011113212131002112111211311111131112311
1113003311111311331020111130111011131111012201322121112201312213121211201021311112111120113130321112
1303210221110121211102120121112101111113311322331111312013113102131101110013011111212232312123012133
1111331223231111330211131012132112121211311333112021131133110131222021321122011112123121000313211112
0133111002312021013110010001011111133211133201112121103313301311211123113121121103111331211322011231
2313311213311123111131011111111211023121123100311110002131131110012121221013132131123311131131101232
2203132331112113101110221220333110031211323001012230011011111133010101123313311100222211111031122212
2030231221112213213113123311111111211211201101111311221012110013333111002113113121301131302201113100
2313222133111111232331113111021021320033330323120121111112113312111223100211210111111112221302101123
1333331311121112311233311123122212112122311113311111011322111311131101130113111112111113133213111113
2111131102133131311222133122102221113110121002101121131111211311101111231021131221111200223111112221
1223112110312112112111013011111313102001132121123211111111311100133211121233111312333111111132020312
1311111122111113111110111223112101201123111313013221120113110010110112213111212121131111111311131013
3301111112101131213111013121112131130121120311302331212213330311001312122322311312301213023231111321
0313111211113110311213311212211130312111103311111121312111121121033121112330231331330121310133111133
0111101111112111211012011001133131201112301313110222132212311131112331111111111121103101111113123310
1013113213311311011120211111231311211333131120131123133112011111111333113111111113201113302111121113
2111131233131203112133111113121111311113121121111223231201311122120131221221112100112211111131312101
3310111133111210321011213113111313322113111123332131111111011211211312321012121311221131112203121102
1111111211122111311231111132131111330123133211331312323201011111113121311112031110233313301032213111
1231233113323233320212112112211131111022321123313121212313311123122131111122321121311211333131113123
1111311331211112133023113010131233002132233211332111131231331133022111021110001222221201313211113211
1112112233131111010111311111121113112011311113310131111113121012313112131111131212031321111112313120
1110110123113011311112113023123231311111011101311122211211131131132121222201311121010212221101112233
1111121113113333123130113133111211031132111111032121212110113121101212212111001113211110202111122121
3313111122211311033012333111310331312013111122122331111111111111313211032231031112112213331111312031
2123321021322113112101321113323110112323312313123322032331132311020112132311322132303231111121121212
1110211210213130111111221311130211312113131011002211231201121111101322331311313122133300121310123011
1111213122321113221313111113311231331101313221311103112123322111221201112312121100023111321303311123
1111111101111130213311213122311130222213111010111111121312221111232112111312131320311110331110131111
2101011111211211113110321321231131321113222111111211211211202122123213210032212112112021113122013112
3311112110110122110133232111011111211311332211112111121133110321131112013121102123131111032103223212
1111331133313212310110011133211123202011121033111112322302213113211311112131101113101113022210032111
0121121110122131111012310203211122112111103213312212320131130111202212213102131310122133112132120210
0211121112111100131321113213311112033213201111112233213231121311120113320112133113113121222231110113
1111301211111232113310111003112101111221301332031211331211311102132122233013211013110112332112230231
1312123111122032103323121023211301311211311213101111131221123201113111021303211211203321112231212211
1211031111111203112112322113212121110331213110321131331131121111110221123131221130011201211112311331
1112111122112110123132123331121021121312121323121031131232102312203130211333111213002312031120122020
1223113311111131102213313113212111111131201111122311122231111301211121222101111101311211111311310202
1212010111211210311011122021133111221122221101211202333111131132111111131111211113103133122121113321
1111010101321302111123221210111111311111213111111321211202120311121110111112311212103132011111233122
1210111223223112233122112111113121131210113112112311231111101211121133331112011101111201321111211130
0021331211011100312211331111212211211113100212121113113113110121221203200121111103121132021302311211
1211211112313132033111132113331111101211031110113011111113131111011221312121213312121100121112021200
3112132111012122121113332112313111313021011111112331133111233113132111213203021111000222231311213102
1111221231113012211111111331130111231113221311231233323201221301310323111223012111321130212301131023
1111112131123321202011111110111331113110112231231101110101311213111320211112121113300112112331213211
1130113321112112031111013112233313121311333311211230212322133013133211113021113121011311113132112120
3321131111102311031112311111011102113213112311132110103201111212123210022212311110232123111102110312
1121101031303220120123131131103203113010123111111211111121111011213230211111223233313311121102112311
2211101231123112301113322101113333112110112131113311213313112211303331103110111111010213311331211311
1313231331111223103113302112311123122011131111121101133111210130133323323211233111221211111211322221
1120103320001112112213131132213021201011301112012113212111323123111110312111111112103122103233103211
0113310111110112021011311131311001011102133212201121131323133230331101012121100211131211013130132012
1221121221131113311131131133302333313312131312111112321011111110311133212312213211100232123213112111
2221113103222311131011111221331112121231221112111111113112111032022132212113111033113131311121211211
0111131012111233101202203131312131021111110113101311111330123213023100131211131321131111112112301121
3213123111302011111331113112321111311210111121131212112211231323111221311111111312113110121111210011
1131310112101111111333231322201131231002311312131112111121221313111311331113111311130302211111132112
2122113121203211310031111111302313132113121331311011131211111112112111112013231212121211223211112331
2132211123312311011211232113111220121032101331011101011130313221111213212231233113123111113212112101
0322121111020011113031121233101321031111123213111212133120111131311110101321213200033113103131311021
1211321203131132301111101011211111211111001111101221132321021333213030110011223211312222332313312233
2113303231033133221311231112321111111110121131111331013111113131321130111111321121133113310330312332
1330101101223232231021023312110131111023111101122331121130121221032223011321121133211212111331113313
2111121112311311311001111131212011211111233121130111302211111123121122112112332232121001100112123100
1311301333111121310111101112211322111113132103321233111122001132231120311120122011133113313131213303
1111123113221211112113111301031231330033312331112311121221131120311203021312032333211111211311113111
1111113313211131302011120110112231311101211111213311112211111133123211323111322101032112323131111211
1201311111101211213321111112301101333122131121231113212122332121111200211111131311022113323131211111
3311131022203231131111120113123111331333110313111131110110101120201111132110331122211112033213311111
1013332101133311133111111123111011312211032131321013212131133311101121213022111011202012111310112212
1131101321112323110211111113211121111323120131113011232131131331201222213332321211111311110123102131
3131313133121201221113211100112201112230011122321211130123130312311311101213210313213131002311132133
1103311301112222121111011031211331133312011323111122312103223000311123211201211211331211103311211331
1223131131011131201311111321331131112311031122011121221111121121111220113121201111111011301032113120
3030201332111121112111201102021101132222121011321113111301012213032131211213121223310331132022111113
1311221311213112111131011112202311121211302211112311133013310122020111121212112123211111131121123212
1121111111112211123221331212113303222111230323013111121331201132113131211111211331103312033111123011
1130112321003312303320113201310313111121231210312331121303221113123221312231022310111311112111113111
2221313211331233321311111111113012211211211131101133232111131131312231120312111301221333111123113321
0111221112133310112011222221331111110321111223221211313133121111211331100132333131101311123121212211
0211111212211213213021001111113122111031221112311231311120131211201111311331321112311311113133311311
2110110120122311111131031111111113120031321221131110113333322132310113110331011211123120111033131101
1131213111233232231201111201110131010131111111011111211131331111113123112111111303110020133211111102
2133121211101223010123001011332313313311121233031112233111301131331233212332313122230031130112102222
