HBNTNHTNNNNTHNTTNNNHHNNNNTHHHNTNTNNTNBNTNTHBNNTNTNNNTHNTTNNHNBNTHBNHNNHTNNNTNBTNBNTNNNTTNNTNHNNTNNHB
TTNTNTNBHNNNHHTBNHBTHTHNHNBNBHNNNHHTHNNTNNNBTHNNNBNNBTTNNNNBTHNNNNNNNHNNTTBNBTTNHNTNNNTNHBHTBTNNHTNN
NNHNBHNNNNNNNHNNNNTTBHBHTHHNNNTNTNNHBNNNNNNTHNBNBNHHHNBHBTNHTHHTHNHNNNNTTNHNTHNNNHNNTNHBNBNNNNHHBHBT
BNNHNHNTTTTNTTNBTBNNTBHHNNNHBTTTBHNHHHNTTNNBNHNHNNTNTHNBBNBHNNNTNTBHHHNHNNNNNNNHTNNNNTNTNHNNNHTHTNHH
HNNNNTNNHBNNNTBNTNBBNNNTHNTNHHHNHNTTNNTNTHHHHNNHNHTTNBNBTNBNHNNHBHNTNNNTHBNNNHNHNBHNHNHNTHNTNTBNNNHN
THHNNNNNBNNBNBNNNNNHNBTNBTTBNNNNHNNNNNNHBNHNTNNNNNNNBBNNHHNNHHNNNTTBNBNTNHNBTNTTNNTNTBNNTBTNNHHHNTNH
TNNBNHNBTNNNNHTTBNTNNHNTTNNNNHNTNBNHNNBTNNNNHHNTTNNNHNHTNTTHNNTNHBNNNNTTNNBTHNNNHNTNNNNNNTNHHNNHNNNN
HNHNTNHHTNBHNBHBNHHNNTTNTNNBBNTNNHNNNTNNTHTTNTTNHTTNTNBNHNBNHBNHTNNBBNHNNTTNNBNNNTHNHTNHTBNHHHNTNNTN
HNHNNNHTNHTHTHTNTTNTTNBBTNNNNBBTTTBNHNBNNNNNHNNNBHNTBNNNNNNBNTNTTNHBBNNNTNNHTTNNHNNBNHHNNNBNHNTHNHNT
NNNTHNNNHTTNNNTHHTNNNTBBNNNNHNNBTTTHTHBHNNNTNHTNNNNBNHNNNHNNNNBTNHNHNTNTNTNNTHHNTTNHHNNNHNNNTNNNNHHN
THTHTHBBNTNBNNBNTNBTNNNNNNNTNHNTTTNNTHTHHBNNTNNNHBNTTNNTNTNTNBNNNHHNNNNHTHNTNTTNHNNBNNHNHNNTNNTTHHTT
THNTNNHHNNNNHTTNHNNNNNTHTNNHNTNHTNNNHTNBNHHBHHBNNTNHNTTNHNBHNTNNHNNTNNHTTBHNNNNNHBNNNNNNNHNHHNNNTTNB
THNNTNHTHNNNNNHNNTNNNNNNHNNTNHTHNTNHTBTNNNHNTNBBNHHHHNHNNHTNHNTNNTNNNHNNTNTHNTBNTTNNTNTHTHTBHTNHHNNN
NNNNNNTNTHTNNNHHBTTTNTNBNBNNBTNNHNNHBTBNTNHHNNNHTTHNTTTTTNTNTTNNTNNHHHTNNNHTNBNTNNTTNTHHHNNNNTNNNHNB
TBHBHHBHTHTTHNHNNTNBNNNTHNNNNHNTHHHHNTHBTHNHHNTTNNNHHNNHHBNNNHNHTTTNTNBBHNHNNTTNNHNNBNTTTNNHNNHTTNNN
NTTTTNHBNHNBNTHNNBHTNNNBHNHNTHNHHHTTNHNBNNHNBBNHBTNHNBNBNNHNBNTNNNNTTBTTNNTTNNBNNTTNNNNHHNNNNNHHNHHN
HBNNNHNHTNHHBHNHNNTHNNHNNNNNHTNNNNTNHBBNTNHTNBBNHNNNTBNTBHHNHBBBNNNNHTNNTHNTNHTTNNNBNNNTTHHNHBHNTTBT
TTNHNNNTNTNNNNTNBNNHNNNNNBNNNNNNHNNNHNTTNNHBNNTTTNNNBHNNNTNBNTNBNTTHNBTHNNHNNNNHBNNTNNHTNNNHTNNTNTTT
NNNNNNTNHNNNHTNNHNNNNNNBNBTNNNHNNHNNHTHHNHNTNNTNNNNTNNHNNTHNNHNBNTHNNNTNTNHNNHNNNHHNHNHNNNNHNNNHTHNT
NHNNBTNHNBHBBHHNTNTNNNHNNTNHNNHNHNNTHNNTNHTNBHTTTNNBTNNHNHNNNNNNTTHBNNTNNBHHNNNNNNBTNNTTNBNHNTNHTTNN
BNTBNNHNNNNNNNNTNTNHNNHNHNHBNNNBNHTTNTHNNNHHTNNNTBTHNTNNNTNNTTHTHNNNNTNNNHNHNTTTNNHHNTNBBNHBBBTNTTBT
BBNHNBNNNHTNTTBTHNHBTNNNTTNTHNNNBNTHHHNBNHNBNHNNTTNNTTHTTTHHNTNNTNTNHHBHBTNNTNHBHNBNTTNNNHNTNHNHNNHN
HHTTBTHBTHHHNTNNNNNTTNHTNNNNHHTBBHNNNNNBNNNNTTNNHNNNNNNNTHHBNHTNTNTTNTNHNHBNHNHNNTTNTNNTTNNHHHNNHTNH
TNHNNNNNTTHBTHHTNTNTTBHNHHHNNNNTTNNTNBNNHNNNNNNHNNNNNNNTHNNTBTNHBNNNHNNTNNNHTHNNNBNNNBHNNHNTTTNNNNNT
NBTBNNNNBNNTTBBTHNNHNHBTHNHBNNHNTNHTNNHNHNHBTBNHTNNNNTNNNNHNNNHHNNNBTNHNNNNNNTNNNNNTTNNNTNNTHNTHBTNN
BNNTHHNNTNHNNTNHBTTNNNTNNHNHHTNHNTNBNBNHHHHTNBNBBHNHHBTNNNNHNTTNNNNTBHTHHNNTNBNNHTNTNNNNBTNNNNHNHNTH
TNBTBNHNTHTHNHNNTNTBBNTTTHTTNNNTHNHHHTTNHTTBTNHNHNTNBHNNTTHNNHNNNHNNNNNNBBNNNTNBNTNHBNNBHHNHNTNNNNNH
NNNNNHNNNTNHTNNTBHNBNTTTNNBNTTHNNNBNTNNHHHNHNTNNBHNHBNBNNBNTNNNHTBNHNTNNBBNTNNNHNNNNTTNNTBTTHHNNNNTN
NNTNBBNTNTNHBNHNNHNNHBNNTNTHTBTNNTNHHNBHNNNHHHNNTHNHBHTNTNHTTTBNNNTTHNNNNHHBHNHNNNHNNHNNNNNTTNNBNTNN
BTTHNHNBNHNNBNTHHHTHHHNNHNNNNNNNTTNNNHTNTNNHNNTBTHBHNNNTTHHHHNBHTNNTTNBHNNBBTTNHBHNNHTNHBHHBNTBNNNHN
HNNNTNNHNBHHHTNTTNNNNNNHNHBBNHHNNNNNNNTHHHBHTHHNHBHHNTHNNBHNHTHNTBHBNNHNNNTNNNTTNBTNNHNNNTNNNHNTHNNT
HNNNBTNHNHHNNHNBNNNHNNBNHNNNNTNHHNBNNTNHNNNTNNNHHHNTTHNNTTHNTBNNHBTTTNTNBBTTHNNNBHTNTTBBNNNTTBHHNNNT
TNBBNTTBHTBNNNNNNBNTNTNBNBNHTBHNNHNNNTHNTTNNNBTNNTHNNTTTNBHBHNHNHTBBNBHBNHNTNNBNHBNTNNHTNNHHBNNNTTHB
NNHNTHTHNHHNNHHNBNHNNNTNNNNNNTBTTNNNTHHNNNNHNHHBTHNHNHTTTTHBBNHTHNNHTNNHNNBBNNNNNNHHNNNBHNHHBHNNNTTN
BNBNNNTNNNNBNNNNHHTNNNNNHBNBNNTNNBTHNNHNNHBTNHNNNBNNTNNHNNNNNNHHNTNHBHBTNNHNNNHNHTNTNNNBNHHHHHNNNNNH
HNHTNTNNHNHBHTHNBNTNNHBNNNHBNNNNNTNNHBNHNBBNNBNNBTTNHTNHHHHNNTNNHNTNNNBTNTNHNHNNHNTNTNNNTNNTNBNNHNTT
BTTBTNHTHNTNHNHNNBHHNBNNNTBNTHHHNNNNNTTHTNTHHNHNTTNNNTNNTNTNTTNNNNHBNBNHNHNTNNNNNNTNNNNHHNNHTNNHNBNT
BNNNNNHNNTTTTNHHNNTHNNTNNHBHNTTBNNHNNNHNTNBTTNHNHNHNNHNHHTHTNHHNHTNHNNNNHNNHNHTHNNNTTNHNNNTNNHHTTTNN
NTNBNBNTBNTNNHTTNHHNNNNNTNTHBHTTHTHNTTNNNNTHTTBNTHNNNTNTNNBNNNTTTBTNNTBNNNNHTHNNNBHHNNNNNNNTHNBNTTTB
NNNNBHNNNNNTHHNHHNNHTTNBBBNHHHBNHHNHBNHNTTNTHTHNNTBTBTNHTBTBBTNNNBBNNNTBNNTTNHTTNHNTNNNNNTHNBNTNTNHN
HHNNNTNNNHNNNNHTNBNHNBNNNTTNNHNHNNBNNTTTNNNNTNNTNTTHTNNHHBNNNNBTNTTNHHBHNTBNTBNNTNNTNNNTNNTNTTHNHBNH
TTNBHNNNNBTNNNNHNNNNNNNNHNHTNNTNNTTNHNNNNNBBNNTTNNNHHBTNHNNTTNHNTHHNNTNNTHNTBTNHNHBNNHNHNHTHHNHBBTNT
NNHNNNNNNNNHNNNNTTBNNHNBTNBHNNHNTBHBNHNNNNNNNNNTHNHNNNHTHTNHTHNNHTTHNNNHNNNNNNHNTBNHBNBHTTHTTHTNNNBH
BHNNNTNNTNHHTNHBNNHNNNNNBNTNNNHHNNNHBNNNTBNNHHHNNNNHNHHTNTBBNHNNBNHBNNHTTHHNNTNBTNBTNHTNNTHNBTTHTNBT
TTHTBNHNTTTNNNHTNBTHNBTHBTTBNHNBHHBHNTTNTNTNBTNBNTNBTHNTTTBTHNBHBNNNNHBTBHTTNNTNTNBBHHBTBHBHHBHHNNTT
BTBHNNNNHHNNNHNNTBNBBNBTNTHNNTNTNBNTHHBNNNNNHHHNNHHNBNNNHNNNNNNHTNNBNHNTBTNTHHHNTNNNBTNHHNTTHNTNTHTN
HNNTNHHBTNNNBNHTTHHNNTNHHTHBTTNNNHHNNHTNNNTHTBNNTNHHTNHNNHHHNHNHNBTNTNNTBNBHTNNBNNNNNBNHHHTTBHNNNTHN
TNHNHNBHNBHTBNNNBNBHNNHTTTNNHTNTBNTHHNNTHBNNHNBNBNNNTHNNHBNTNTHNTNNNNNNTTHNHNNNHNHNHNHNNNTHNBNTHHNHH
NNNNHTNTNTNNHHNTNTBHNNTNTNTBBNNTNHBNHTNNBTTHTHHHTNHNTHBHHHHTNNHNNNHTNHHHTHTNHNHNTBHTNTTNNNHNTNTNTTHH
NNHTBNTHBBTTNNTNBHNHTNHHTHTHTNNBTTNHTHNTNTNHTNNNHHHNTNTNTTTBTNHTNHTTHHTNBBBNBNNNTHBNNBHBNNNTNHNNNBNN
NNNHNNNNNHNHBHBNHTTTBHNNHBNHNNNNNBTNHNNTHNBBNHTBNTNTTNBNTNTHTHNNNTNBHBHNTTTNTNNBNNHNNNNNTNNTNNHNNNTT
TNHNTNTTHTNNNNNNTBHNBNBHHTNTBTHNNNTNBHNNHNTBTTTNNTTHNNHNNBNNHNHTTNNTNTNHNTTTNNHHNHHTNHBNHBTNHTNNTBBH
NNTTNNHNNTTNTTHNNNHHNNBHTHNNNNNNHNNTTHBBHNTNHBHNTHNNNNTNNHNTBNBNNHHTNNNNNNNNNTNHTNNHBNNNTHNTNNBNHHTT
HNNNBNNHNTTTHNHNNTTBTNNBHBHNNHNNNNNNHNTNNNNNTBHTBNNBTHHNNNTBBNNHHNBNBNNNNNNNHTNNNTTNHNNNNNBNNHTNNHNH
HNTTNNNNNTHNTHHTTNHNNNNTHNTTHTHNNNNHBNNTHTNNTNNNHBTNNNNNNNNNNBBTNNHNTHBHNBNNNNNNTNBNBTNNTNNTNBNTNTNN
BNNNNHNNNHNNNBNNHNTTNHHTNHHNHNNHTNBNNNNBNTNHHTHNTBNHHBNNNHNNNHNNHHTTTNNNNNHNNBNNNNTTNTNNHNHNTNBNHNHN
NHNNHNHTTBTHHNNNNHNNTNNNNNHTHNNNNTNNTTTTNHNNNHTTTTTHTHNBHHHHHBHNNNNBNNBTHNBNNNNHTTBBNNHHNBNBNNNNBBTN
BNTNNHTNNNNNNHHNTHHHHNNNNNNNNNBNTNTNHNTBHHNTNNNNHTNNTNHNNHNNNNNNNTNTNTBNNTNTNBTTNBNHTNNNTNHNTNBBTNNN
TTHHTBNNTBNBNNNBNBNHNBHNHNNTNNNTNNNTTNNHTTNHHHHNNNNBHNNNNNHTNTBHBNTHNHTHNNBNNTNHHHNHHNHBNNNNHNHTNNNN
NNNNHTNTNNNNNNNNNTTBNTHHTHNBBTHNTNBNNNHNNNNNHBNNNTNNTHTBHNHTNTNNTNHNBNNTNNTHTNBBNTNBNNHHNBTTTTTNNBNH
NTNNBNNNNNNTNBNNHBTHTNTNNNBNNTNNNNNNNBNNNNNNNTNHNHNNNHHHNNNHNBNTTNNBTNTNBHBNBNTNTNNNHNNNHNNHHNNHHNTN
NNNNHNNTNHTNHNTHTTTNNNHNTBNNNHBNBNTBHHNHNTBHNTNBBBNTTHHHHTNTNNTNTTNTNHNNNNTNHNTNNHNNHTBNNNNNTNNNHHTN
HNNNNTNTNHTTNNNNNNNHNNTNNTNNNNHHNNHNNNNHTHBHHBNNNNNNBBNNNBNNBNNNHTNTNHNNNNNNHNNNBHTTTTNHNNNHNHBNNNNN
THHHHBNHNTNNNTHTNBNHBNNBTBBTNNNBHNTHNHNNNNNBTNNNNTNBNNHTBNBNNBBNTTTNNTTHBTNHTNNHHNNHNNTHNHNNHHNHTNNN
TTNTNBTTBHHNTNNNBNNNNHTHNNBTNNBNTNHNNNTHNNNTNNNNTNBTNBTTNNNTTNBNNHHTNNNNNNNHNNTTHBNHHNNNNTTHNNHTHNNT
HNNNHNNBHNNNNNNTNBNNHHTNBTTHNNNNNHTTNNHNNNNHTNNNTBBNHTNHNNTNNTNTHNHBTBNNNBNNBTTNTTNBNHNTTNNNNNHHNTNT
NTHNNNNTHHNNHBTNHNTHNHNNNNTNTHNNNNHHTHTNNTNHNHNBNBHTTNHTNBBBTTTNNHHNNNHTNTHNNNHNNNNNTHHHNHHNBNNNTNNN
NNNHBNNNBTNTBBTTNNNBTHTHTNHNNNNTHNNNNHTNNBHNTNBHTTHBTNNTNNHTNNBNTTHNTTNHNBNNTTNNHTTBNNNBNNNNNNBTHNBN
NBHHTNHNTHNNTBNTNNNHNTTHNNTBNNHBTTNTNNNTTNTNNHNBHBNNHTTTNNTNNBTHNNHHHNNNNNTTHTNTTTHNTNHHNNHNNNNHHTNN
NNNNTTHTBHNBNTNNNBNNBHHBHTNNNNNNNTBNNNNHNNNNNBTTTTHHBNNNNTTNHNHHTHNNTNNNTTBHHNNHNHTHNNTBNNNTNTNBHBNN
NTTHNNTNNNTNTHNBNNNNNHNNNNNTNBBNNNBNTBTBHNNTTNHTNNTTNTHTNNNHNTTNBNBNHTNTNHHHNTTHHNNTNNNNTTNNTNBNTHNH
NNHNNHNBNHTHHTHTHBNTNTNNNBNHNNBNTNNHNNTNNTNNHNNNNBTNHNNNNNBNNNNHTTTNHTTTHNNNNNNBNNTTTNNHNTNNHBNNTHNN
NHNNTTTNBNNBTTNNNTNNNNNNNNNTNNNNNBNHTNNTTNTNHNHNNBTNHTBNTTTHNHNNNNHHNHTTHHNTBNNNNHHNNNNNNNNNBNHBBNNT
HNHNNTNNNHNNHNHNNNNNHHNHTNTHNNTNHBBBTNHNNHHNNHBNNHNTBNHBTNBHBNNHTNNNTBNNNNNNNTNHNTNTNNNHBNBNNTBNNBNN
NBTHTNHTNTNHNTNTNBBNHTHNHTNHNHBHNHTNNNNNTTNNNNHTHNNTTTHNTNNHTHHHTTTTTTNHHBNTNNHTHHTTTTHNHHNTNTNTHBTN
TNTNHTHNNBNNNNTNNBNNBNHNTTTHHTNTTNNHNNNNHNNHHNNTNNHBHNNTNNNNTHTHTNTHTNNHBNNHBBNTNNNHHNNHBHNTNTNHNHNN
NNTBNNNBTNNNNHNNHNNNBHHHNNNHTTNNTTNNNNNTNNTNNTHBTNTHNNTNNNBNHNBNNNNHNNNNHNHTHNHHHBNTNNTHNNHNHHHHNTNT
THTNNHTHHNNTHNNTBNNNHNHBTNNTNHHNBBTHBTNNHNNHBNNNHNHBTNNNNNNHHBNNTNNNHNNHTNNTNTNHBNHNTNNNTNNTTNNHTNNH
NNBNBHNBNBTNHHNHNHHNTNHHNHNNHTHNBTNBNTHNTHNBNHNNTNNHBNNNTNNTNNNNNTNNNBNHTNNNNNNHNHNNNNNNBTHNHNNBTTHN
TTHHNNNHNBTNBTNTTNBTNHHHNHNNBTNNTBTNNHNTTNNBTNNNNNTTNNHNNHNNHHNNNHNHHNNHNHHHBHBNTNHNNTNBBNTNHNHTNNNB
HTHNTTTNNTHNNNBNNNNNHNNTTHNTHNNNHNNTNHNNHTHTHHHBNNBHNNNTNBNBNTNTNHNTTNHHNNNNTNNNNBNTNNNHBNTNNHNNBHTN
NTNTHHNNBTHTNNNNNNNHNNNHNHNHHHHTNHNNNNNNNHTNNNNTHNTHNNHTHHHHTNNTTBTNTNNNHNNTTNNBNTNNNBNNNTTBTNNNHHTB
HNNBTNNTNNNTNNHNTNNNBHNTNTTTTNNTHHNNNNNBHTNBNTNBTNTNBHNBHNTNHNNNHTNTNHNNHNTTNNHHNNNBHNNNNNNBTHHTBNBN
NBTHNNBTTTNNHNHHNNHBNTNHTNNBNNTHTNBNNNTBHNHHNTNBNNTNTBNNHNBHTNNNHNNNTBTTNHHTHBNNBNHNNHNNHHHNHHBTTNNN
NNNTTNTTHBHNNNBTHBHNNHNNNHNHHNHNNHTHNTNBNHHHTNNNNNHNNHNTHNBNNHBTNHTHNHBNNTBHNNHBNNNTBNBNHNNTBHHBNHNT
THBHNTHTNTBHTNNHNNHNBNHNNNNBNTNBHHNNTTNNNNNNNHTHTNNNNNBHNHHBBNNNNNNHNHNNBHTHNNBNTNTHBHHNTNHNTNNNNTNH
NHHTHBBNTBNHTNNHNBHNHTNNTHTNNTNTNBTNBNBHHNNHHNNTNHHNTTBNNNBTHNHNNHHNNTNHTTTNBHNTNNTHNNNTNNHTNBNTBNBT
NNTNNNHNNNTTBTTHNNHTTHNTNNTNTNHNNNHNNNTNNTNBNNBNHNHTNTNHNNNBTNHHNNHBTNHNNNNTTNHTHNBTTTTTNTNHNNNBBNTH
NNNTHNNNTNNNTHBNNNNHNNNBNNNNBNNBNTBHHTNNHNNNHNNNHHNTHNNTHNNNNNBNBNNNHBNNBNNBNNNHTHHTNNNBHTNTNBBNNBNB
HNTBTNTHNHBNBNHNNTHNNHHTBNNHBNNHNNBTBBNHTNNNTHHHNHNNNTNHNNTHNTHNNHBNHHTHHTHTNBNNTNTNNNNNNNNTTNHNNBTN
NHHNNNNHNNNHTNNNNHHHNNHTNTHNHBTNBTTNTNNTHNNTNNTNHTNNBNHNTNNNNNNNTNHNTHNHHHHNNNTNNTHNNBHNNNHTHNNNBNNN
HNNNNNTNTNNNTTNNNNNNNHNNTNNNHNHNTNHNHTNTNNHNNNHHNNNNHTBNNHTNNNTBNTNBNNNBTHNNNNNNNNNBHHHHNHHNNNHNHNNH
TBHNNTHNNTNHBHNNTHBHTTNBHHHHNTHNTTNNHNHTTBTNBBBNTNTNHNNNNNTHTNNBTBNHTTNBNTBTHTBTNNNTNTNNBNHNBTTHTBNN
NTHTNTNNNNNTNBHBNBBHTHNBNNNNNNNTHTNHNTHNNNHHNNNTTTNHNNHTNNNHNHNNNHTHNHNNTTBNHNHTNNTTNHTNHNBNBNNHHHNH
NNBNNNNBTNNNBNHNNBNNTTHHTNNNHNTHHNTNTNHBTHTNNNNNTHTNNNHBNNNNHTNBTNNNNNTTTNHTBTNTNHTTTHTNNNNNNNNNNBTT
NNNNTNBNTNNBBNHTTNBTNNTNHNTTTNNHBBBTNTBNNTTHNNTTNNBTNNTNBHNTNNHNTNNTHNNTNTTNNNTNNNNNTNHNNBTHNNNNNHBH
NHNNNTNHNNHBNBHNTHNTTNNNTNNHNNNNNNNTTNNNHTNTBTHTBTNNNTTNNNNNTBNNNBNBHNNNNTHHNNNTTHNNNBNNTTNTBNTNBTNN
BNTNNBNNHTNNNTNNHNTTNNHNBNHTHNHHTNTNNNTHNNNNNNHHNNTTBBBNNNNNNNNNHTHNHTTNNHBNNTNNBTNHHTNHTHTBHBTTNHNN
NTNHNNBTNNHNTNNNNNHNNNNNNHNNBNTHBBTNTHHNBBTNTTHNNHNTNNNNNHNTTNHNHTNNBNNNTNNNBNNNTNHNNNNNNHTNNTNTBTNT
TNBNTNNHBHTNNNBTTNNHNNNHNNHTHNNNTNNNTTNHNNHNNNTNNTNNNNHHNHTNNNTNNNNTNBBBNHBNHHNTHNNNHTHTNNNNHHHTNNNT
