NHNHNHHBNTHNTBBHNNNHNTNNHTTHNNNHBNNTNNNHTNNHBHNNNNNBNNTBNTNNTNNBNTNTNNTNTHHHNBNNHBTNHNNNTHTHTNTBHNHN
NTBNHTNTNNNNNTHBTNHNTNNNNNNNNNHNTNNBNNHTNNHHTHNNNTBNBHHNNNHNNTNNNBBHTNNNNNTBNNNBHNNTHHTHNNBNNNNBBNNT
NNNTTHHNTTNNHNHNNNNNBNHBTNNTNTBNNNNNNTHNNTTNNHHNTNBHHTHTHNBNHNNNNHTNNNTTHNNTNTNTTNNHNNNHNNNTTNTHHNNB
NNHNNNHNTHNNNBHNNHHHBTNNNNHNTHNHBNHNNNBHHHHBTTTNBNTNNNNNTNTTNTHNNNNTNTNTHTNNNNNHTNBNTNNTNNTNNNTNNHNH
BHHHNNTNBHHHNHBNNNNHTNHNNHTHNNNHTNBTNHTHNBNNNNHTNNNTHTNNNNNNNNHNNTNNHHNBNNNNNNBNTNNTHNTBNTNNTNNHNHNN
BNNHBHHTTNNNNTTHNNNNHTBNTNNNNNTTNNHHBNHHTHTNTBNTNNHTHNBNNTNNNHTNNNTNNTNNBNNTHNBNBHHBBNNNNBNBNNBNBHNH
TTTBNTNNNNNNNBHBNBTNTHHNNHNHBNNNTBTNHNNNHNBNNTNNHBBNTNNHNHNHHHTHNNNHNNNHHNBNHTHNNNNHTHTNNNTHNHTNHNNT
HHNHNNBTBNNHNNNBNTHNTNTNNNBNBHHTHNNNTNNBNBHBTHNTTHBTBHTNNHTHTHBNNNNNNBNNTBNNBHNTBNHNNBTNNNHTNNBNNTTT
HBNNNHNNTBNBNNNNBNNTTNNHTNHTHNNNTNTNHNBHNNHHNHBBNHTNHNNNNBHHNNNNNTNTHNBNNBTNHTNTHNHNTNNNNNNHNBNNTHNN
TTNTBNNNTTBNNTNNNHBTHTNNNNTNNNNNNHNBNHNBTNNTTHTBNNNNBBTHNTNNNNHNNBHNNNNNNNTNNNNNTHHHTBHHBNHNHHHHHNBH
NHNBNNHNNNNBNTHTNBNBHNNNHHBNHBNHNNTBHNHNNHHNHNHNTNNNTNNNHHNHTNTHHBTNNHNBBNBNTHBTNHHHNNNTTBHNTHNTNTNN
TNNHNTNBHNNNNBTNNBNTNNNHNHNTTNNTTNNNNBNTNNNTTNNBHNNNNNBHNTNHHNNHNHNNNHNNNHHNTNNTNHHNHTNNHTBNTBHHHNNB
HNHTBHHNHNHNHTBHNTNNBBHNNHNTBTHNHNNNNNTNNNNTNTNNNTTNTTBHNHNNNNTNNHHTHHHNHTNHBNTNNNNTHNHTHNNNNTHNNHNH
TNHHHNTNNNHNTNNNTBNNTHNHBNNNHNHBTHNNTTNHNHNNNHNNNTTNNNTHBNNTHTHNNNTNHBBNBBHNBNBTTTNNTNTHHBNNTNNNNNHH
HTHNHNTTNTBTNTTHBNBHTNNNNNNNNHNHHTHNHBHNNHHNHTTTTNNTHNHNNHNNNNNNNNNHHNNNNBNNTNNNNNHTTHBNBNBBNNTBNTNH
THTTHTNHBTNHHTNNTNBNNHHHHHNNBNTHHNNNNBTNNNTNNBHBHNNTTBHTNNNNNTNHNHNTNNHNHHBNHBNNNNHHHHNTBNTTNTHNTTTN
NNHBTNNBHNHTTNHNNNNTTNNHNNHNTHTNTNTHNNTNHHNNNHNNNHNHHTNNTHNNTNNNTNNBNNTNTBHTNBHBHNNHHNNTNHNNTNNBTBHH
NHNNNTNNHHHBTTTTNNHNNTTBTHHNHNBNTHBHHTNNHBTNBNHNNNTNHNNNHTNNNBNHTNTNNNBNBNBNNHNHNTTNNNBTNTNHHNTNHBNT
NNBNNNHBNNTNTNHBNTNHHHBNNNNHNNHNNHNTNTBTHHNTHNTNBHTNNNTNNNHTTHHHNHNTTNTTBTBNBNHNNTTBTHNHBHNNNNTNNNNB
TNBNBBHHNNNNHNHBNTNHNNNTBTNTNNHHNNTHTTTHTHBNTBNNNNNTNHNTNNTNNNHTHNHHBNBNNNHHHHTTTHNNHTNNNTNNNHHNTHBT
HNNHNNNBBTNNHBTTNNTTNTNTBNTHNBNNNNHNNBNNHNNNNTNNHNNHHNTTNNHNNTBTTHTNHNHNNTHNBNHTNNNHTNNTNHNTNNNHTNNT
NBNNNTHNNTTNTBNNNBHNBTHBNTNNHNHNHTNNNNHNTBNNBNBNBNTTNTHHHBNHHNHNTHHNBNNNHHNNBHBHNNTHNNHNNHTNNNNHHBNN
HHTNTNNNNNHNNBNNNNNTTHBBHTTNBNHNTHHTNNTHTBTNNNNNTNNNNNHNBNTHHNNNHNNHBNBBTHNNNBNNHTNNHBNNHBNHHHTNBNNN
NBHNTNHNNBHNNHNTHNNNHNNBNTNBTHNNHNHTTHNNNTTHNNTNNBTTNNNHNHNNBTTTNBNHTTNNNHTNNHNNNBNNNTTBNNTNHHNNBNBN
NBHNTNNHTNNHNTNNBNHNHHNHHHHNNNHTNNNTHNTNBHTNBTNNNTTTBBNNNTNHNNNHNTHNBHHTNHNNHTNHNHNNTNHTTNNNTTNBNBHT
NHNTNBNNNHNHHHHTNNTTNTHNBHTNBHBTHHHNTHHNNTTHBNBHTNBNHNNNHNNNNHHNNTNHTHTTHTHHHNHHTHNNHHTNBNNNHNTTHNNN
HNNNNTNHHTNNNHHHNTNNNHNNBHNBTNNHHNHNNNNHNNBHHHHNBNHHHTBNTNTNNTNNHNHNNNNNNNNNNNNNBNHTHBHNHNHNNTNBTNHT
HHBNTTTBTBHNNHNNHHNNNNBHNNNNNTTHNNHNNNHTHNNTTBTTNHNTNTBTTNNBBBTNHNBTBNTNNBHNNNNHNTNNHNBBNHTNHHTNBTHH
NHTTHHHNNNHHNNNNNNNHHNNHNBNHNNTNTTNNNHNTHHTNNNHNHBNNNNNTHBTHNHTBHTNNNNNTNTTNHNNNTTNNNNTNTNNTNHNHHHHN
THNNNNNTNNNNNNTNBTHHHBTHNNNNHBNHNTNHBNTNNBHNNNNTNBNNNTNHHNHHNHNHBNBNHTNNHNNNNNHNHNTNTTNNHBNTNHNNNTNB
TNNBHBNNTBNBNTNHNTNBNBHNHNHTNTNBHTNNHNNNHHTBHNTNHHNTHNNHTHNHBTNHTNNTNHNHNNNNNTNHNHHNNBNBHNNNHNBNBNHN
NNNNNNNNNNNNNNTNNHNNHHNBHTTHNTBNNHBNTNNBTNHNHHNHHTNHHNNTHTNNTTHTHNHBNBTTTNHTTTNTHNTHNBTNNNTNHTNNNNNB
NNBNNNTNNTNHHNNNHTNBNNTHNHBTNBHNNBNTTTNHBBNNNBTHNHHNHHNNBHTNHTHNTNBBTHNTNHHBNTNNBHHNHBNNTTTNNHTNTNNN
NNTTHNTHNHTNHTBNBHHNNNNTNNBNNTBHHBHNHNTNNNNTNNNNNNNNBBNNTTNHTNNNNTBNHTHNBNNTNNHHTTBNTNTTNHNNTTNHNTNH
HBTNTNTNNNNNNTHHTBNNNTTBBNNHNNHNHTHHBTHNTBNNNNBNNHNTNNNNHNTHNTNHTTHNNTBHHNNNNNBNNHNNNNNNTHNBHBHTHNNT
HNNNTNTNNTTHNTHNNNNBTNTBNNNBNNNBNHBNNNTNNHNNNNBHHHNHTNNNNNNBNHHNNBTNNTHNNNNNBNNHBNNNNNNTNBNNNTHTNHBN
NNHNNNTNTNNNNBNNTTNHHNHNBNHNNBNNNNHNTNBHBHTBTNNBBBNHNNHNNTTNNNNNNNTTNTNNTNHNBNNNNTNNBTNNNNTNNTNNNNHT
HHNNTNNHNNTNNNNTNTTBBNNBHTBNBNHHNTNTTNTNHBTNNNNBNTNNHNHNTNBTNTNTHNBTTHNNNNNNTHNNNHHNNNNNTTNHBTHTNNNT
BNHNHNHNHNNNBNNNTTTHNTTHTNNNTTNTTHTNHTNHHNTNBHHTBBBHHHNNTHNHNTNNNNNNTNTNTNTTTNTNHTNNNHTTNNNNNNNTNNNN
NTTNTTNNBNTTNHBNNBTTTHHNNHNBNHTNHTHTNNTHBBHNNNNHNNNBBNHNNTNHNNNNHNNNNTHNNNTNNNNNNNNHHHNTTHBNBBNBTNBT
NNTNHNHNNTBNHHHNNNNNTNNTHNNNTTNNNTNNHNBTNBHNTBNTHTTTHNNNNTNNNTHNNNNNHNTTNNNHBHTNTTTBNNNNTHNHNTHBNNTT
NBNNNNNHHNTNHNTNBHNNNHHTNNNHNNTNTHHNTNTBBBTNHHNNNNNNNHHHNNNNHTTNHHHNNNTNNNNBHNNNHHNNNBBNTHTBHHNNHNNB
THNHHTBBNHHTNNNBNNHHNNHHNNBNHNNHNNTNNHTTNHTNNTHNNNNHTNNNTNNTHNBNNTHNTNNNTNNHHHNNHNHBBNNTNBNNHNNNTHHH
TTNTHTNNHHNHBNNNNNTNTHHTTNNBHTNNNNBTNHTTHHNNHNNNTHNTNNNTHTNNNNHNNNBNNNNNHTHTTNBHNNHNNTBNNNHBHNHNTTTN
TNNNNNBNNNBNNHNTNBHHNNHHNBHHTTHHNHNHBNNNNNNNNNTBNNNNNNNNTBBHNTHTTNTBNNNHNNTNBNNHBNBNBTNHBNNNHNTNHNHN
NTHBTNNHBHNHHNHHTTBHNNHTHNNNHNNHNTHTNTHNNTTTNTBNNNBHTNBNHTNNHTNNTNTHHTNNTNTTHTNTHHNTHHNHNTTBNHNNNHNT
NNNTTHTNNNNBNHNNNNHNNBTBHNHHNTNTNHTTNTBNNNBBNNBHTNNBNNNHBHNHNTNTNTHNHTHNNNHHNTNHNNNHHTTHTNBHNBNHNHTN
HHTTTNHBNHHTBNHNTBNBBHHNTNNNNNNNNNHNTTNTNHTNNHTHNTTHHTNBBTNNHHTTTTHHTNHBHNHTNHNTHTNHNTNBNNBNHHTNHNTT
BNNHTHHHHTNHTTBTBTHBHNNHNNNTBNHNNTTHNHHNNNHNTNBNNHTHNNNNHTNNHNNNTBTNNBNTHHNNNBTHTNHNHNTHHNTTBNTBNNBB
HNBBNNNNBHNTHBNBTNNTHNBBTHNHNNNHNNNBNNBBNHNNHNTBHTHBNTTNNNNHNNNTNHNNHTNHBBNTBNTBTTNTHTTTBNBHBNNNNBNB
NNNHNNNNNTHBTTBBTNNTNNTNNNTNNNBHBBTHNHNNNHNNNHTNBNNNNNBTNBNNNTTTBHNTNNTHNNNNNBNTTNNNNNNNNNHTTNNHNNTN
NBNHNNNBTHHTTNNNNHNHHNTHHHNNNBTTNHBTTHNNHNBNNNBNHNNBNNHHNNNTHNHNHTTNNNNHNNNTNNNNHNHNNNNNHBNTTNNNNTHT
TTHHNNTTTNNTTNHTNNNNNTNNNNBTNNHTNTTHTHNHNHBHNNHNNTHHHTTNTNNTTNHNHNNTNHNBTTNHNNNTNBTNNNTNNNNNHTNNNTNN
BBNNBNBTNNTBNNHNTNBNNNNNNNNBTNNNTBNHHNNHTTHNTNHNNNHNNNTNBHTNHTTTHNHHNNNNTNNBTNTNHHNNBTNHTNTHHNNNNBNN
HNHNHNNNTHBNBTNNNHTNHNNNNNNNHHTBNNNTNHTBNHNBBTNHNNNTHNNNHBNHTNHNTNNNTTNTNBHHBNNNNNNHNBNHTNNTBNHTBNNN
TNHBTTTTHHNNHTHHHTBTBBNNNBTNNNHBHTTTTHBTTNTBNNNTBNNHNNHTNNTNHTTNNBNTHNNNBNTNNTTNNNHTNTNNHTTTBTNNBTNN
NHHNBNNNTNTNHTBNNTHTNHNNTHTNNHHNNHHNNHTBNNTNTNNTHHHBNNNNNTNNNHNHNBNNTNBBNNBNNNHTTHTNNNBHTNNHHNBHTNTH
HHTNNTNNNHNHTTNNNTNNHHBHNTTNNHBNHTHHNHTBHNHNNBNNTTHTNNNNTTNTHNNNBNHHHTNNNNTHTTHTHHNTHNNNNHBTHNNNNTHN
NNNNHHBHTNNTNHTNNNNNTHNNNHHNHNNNNTTTTHTNHNNNTNNHNHTBHHHNNNTNNTNHHNNNHNTHHTNNNTNNNBTNNTHNNNNNHTBNNHBN
HHNTNHHHTTNHTHBNHHBTNBHBTNNNNNNBNNNTTHHNNNTNTHNNNHTTHHNBNHTNTHNHHTBTNNNNTTNHNNHHHHBNNNNNHTNTNNNHTTNH
NNNHNNNTBBHNNNNNNHBNTNHBTNNTNBNNNBNTHHHNTNNNTNHNBTNTNNHNHNNNTTNNNNHTNTNNBTHNNTNHNBNNTHNTNNTNHNNNHNTT
THTHNTTBHNHNHNTBHTTTNNTNNNNHTNHTNHNNNTNTHNNNBNBNHTBHHNHNNTNNNNNNHHNNBTTHTNNNTTTBHBNTTHNBNNTNTNTTBNNT
TNNNBNNTNNNNNTBHBNNNTNTBHTNNTNNTNTTHBTHNTNNNNNNHNNBNTNTNNTHNBNNTTNBNNNNTBNBNNTNTTBNNHTNNBTNTNNNNNNHN
TBTNNHBNHNNNTNHHTNTNNHNNNHNBNNNTHNTNNBNNHNNNHNHHNTHHTHNNNNNNNNTTNNNBBNHTHNHNBNNTNNHNHHHHHBHNHNTHTNBN
HNNNNNNHHHNNNTHNNTNTTTNNHNBTNHNNTTNHBBNBTNHNHTBNNNTHNNNHHNTNNNNNBNHNHTBHNNHNBTHNNNNNNNNTNNTNHHHNTNHT
NNNHNTNNHNHTTNHBNHTNNNNNNTBNNHNNNTNNNNNNNNHTNBHNNHTTNNHTNNNTNHNBNNNNNBNNTNNNHTBHTNNNBBNTTBHTNNNHBNNB
NNNHNHNNBTNNNNHNHHTNNHNNHHHNTNHNHNHHNHNHTBHNNTNHNHHNNHNNNNNHBNNBBNNNNNNTNNNNNTHTNNNTNNBHNNNHNNNTNNHB
NNNTNNNNTTHBNHHNTTNNBHTNBNTHBNBTNHBNTBHNBNTTNBHNNHNNHNTHTBTNNNHNNNNBNNNNTNNTHNBTTTNBNNNNNTTHTNNTNNNN
NTTNNNNTNNNHNTHHNHTHNHTBTNHTHTHNTNHNNHNNNNTNNHTTHBTNNTNTNNHNHHNNNNNTNHHNNTTNNNTNBHNNNTBHHNTNNTNNNNBB
HHNTHNNHHHHBBHNHNTNHNHBNHTNNNHNNNNHNNHTHNTHNHNHHTHNTHNBHNHNNBNTNNNNBTTHTNNNNNNNNTHNHNHNNNTNNNNTHHNNN
NBBNTNNHTNNNBNNNNNBNTNNNBHNNNHNTNHNNNTNNNBBNTTHHNTNHNNTTBNNNHNNTBNNNNTTBTNNTHNTNHTBBNHNHNBHNHHNHNNBN
NNHNHNHNNNHNNBHHHNBNBNHTNBTBTTNNNHNNNBNHNHBHHBNNHTHHTNNBTNNTNNNHTNHHHNBTBTHHHNNNNHTBNNHBHNHNNHHHTNHT
NBNHNNTNTTNNNTTNNNNNBNNHHBNNNHHNNNNHNNHHNNHHHNHTNTNNNHNNHNNTTNHNTHTNTHNNTHNNBBHBTNHTHTNNNTNNTNHHNTTT
NBNBNNHNHTTNBHNNNHBBTNNTNHTNNHTNHHTNHNHBNHNNHHNNTHNHTNTNTBNHBNHTNHNNNTTNBNNNNTNHTTNTNBBHBTHNTNTHNBTN
HNNNHNTNNNHBTBBHNNNNHNNNTNNNBNTBNBNNTNBNNNNTHNHTHBNNNTNHNNNHNNBHTNTBBHNHNHNNTNNBNNNNHHNBBNNBTNNNBHNN
HHNNNNNNTNBTTHTHNNHHBNNNTTTBNNNNNBNNNNNNNHBHNNTNHHTTNNNBNBNNNTNNBTNNNTNBNNBNBHNNNHNNHNHNTNNBBNBTNHNT
BBNBNNNBHBNHNNNHNNNBNNHTHNHNHHHHNHHTNNBNBNNNNTBHBNNNHNNNBNTHTHTNNNNNTNHNNHNNNNHNHTNNNNHNNBHHHNHHHNTH
NNHTNTNHNNNNTBNNNHNTTTTTHTNNNHHNTHNTNTNHNNNHNTNNTHTNBTNHNNBHHNHTBNNNHHHNBTNNNHNHNHNNNNNNNBHBBTBNNTNH
NBTBNNHNBBTNNHNNNHNNNNBBTTTTTTTNTBNNNNBBNNNNNHNNBHNHNTTNNBNTNHNBNHNHHHNBNTNTNNBNHTNNBTNHHBTBHTHNNHNH
BNNHTTNNNBNBNBTNNNNNTNNHNTNHTNNBNNNNBNNNTHNNNTNHNTNHHNNHHNNTNBNNTHTTNNTHTNNNHNNBNNNNNTNNTNNNNNTBBHTN
NNHTNHNHNNNBTHHNNNHHNNNTNTHNTNHNTBNNTTNNHNNNTHNTHTNNNNHTNNNBBHHNNNHNTNBHNNHHHNHNNNNNNNNBNNNNNNHNHTBH
BHNHNTHNNTNNHHNNNTBNNNNTNNNNTHNTBHNHHNNTNHBHNNTTNNHNBBNNHTNHNNNNNTNNHNHHTHBNTBNNTBHNHNHTTHNNHNNTNNNN
NHTNBNNHHHHNNNNHNHNNNTHNNTTNNTTNNBTTTBNNBNHNNTHNNNTBBNTNTNNHTBNNHNNNTNNNNNNNBNNHNNNHTNNNNTNNTNTNNHHT
NTNTBHBNNBNNTNNNNNNNNBHTHTNTNTNBNTTNNNNTTNNNHTHNNTHBBNHTNNHNBHTTTNNNNTBBTHNHNNNNTNTBBHNNHTTHNNNNNHNN
TBHNNNNNTNHNHHNHNHNNHHBNNHNHTHNTTNTNTTNNHNNTNNNNNTHTNBHTNNNTHNNNHNTHTHNHNHNNHTNNTBNNHNNBNHTNNNHHNNNT
HBNHNHBBNNNHNNTHNHNNNNNNNNTNHHHTTNNBNNNNHNNTTNNNBBHTNNNHHTTBTNNBBHNHTHNNNNNHHHNNNNHNNNHTNNNNNNNNNNHN
TNTNTNNTHTHNTNNTNHHNHTNNNNTBHNHNTNNNHBNHHHNNHNHHHNHNHTNNNNNTNNNNTNNTNHNNHHNNNTNTNHNBHNNHTTNBNNNNNNHT
THHNHTBHNNHHTHTTTHTHHHNNNTNHBNHHHTTNNNNHHNNNNNHNNHHNNNNBNTTNHHNHHBHNHHTNBNHNNBTNNTNNBHNNTNBNHNHNTBNN
HNNTNHNNTNNNTBHHNHNTTHHTTNNTHTTNNTHNTBTHNHTNTNBNHTNNTBHBTTNNTNTNTHNNHHHTNTNTNBNBTNNNNBHNTNNNTNNNNHNT
NHHNNTNHBNNNNNNHHNHNTHNTBTHNHTNNNHNNNNNNNNHNNTHTBHNHNHNTNNBNTNNNHNNNBTTNTNNNNTNNNNNNNBNBHNBBNTTNTNNN
NTNNTTHNNNNBHHTNHHNHNHBHNHNHNHTTNNBTNBNHNNHNHNTBTNNTTTNTNNTBHNTNNNNNNNNTHNHNNNNNTTNNTHHTNNTBTNNNHNNT
NHNHNBNTNTNHNNHHNNNBNTBTNTHHTNNNHNNNNNHNNNNNNNNHNNNNHNNNTNNBHNBTBBHNNTNNNNNHNNNHTNNTNHBNNHHBNNNNHHNN
HTNNHTTNHBHTNNTNNNNNTBBTHNHNNNHNBTNHNTHTHTNTNHNNBNNTHNNHHHNBNNHNNHNNNHBTTHHTNNTNNTNNHNNNNNNNNNNHHNTN
NNHTBTBTNNHHHHNBTNNHTHNHBHBHTNNNHNBNNTHTHHNNNHTNTNNHTNTNTTTNTNNNTNNTNBNNTNBTTNTHBNBNBHTNTTNNHNNNNHNT
NTNHTHBHNNNTTTTNNNNNNHNHNNHNNNTNHHNNHNNNTNHNTNTNHTNHNNTHTNNNHNHNNNHNHNTHNNNTNNHNTNTTHHNNTHTBHHNNTBHN
HNBNNTTBBNNNHNNNNNBTTTNNTNNBHTTTNNNHTNBNNNHNNHNNHBHNTHTNNHNTNHNNNBNHNTTNNNNHBNNBTNNBNNBHTNHBTHNHHNBT
NTBHNNNNNTTHHNHNNNNNHNNNHBNNNBNNHNNNNTHHNNNTTNNTTTNHNNNBTNNHTNBNNBHHTTNTHTNNNNNTNNHHTTTBNNNHHHNNNNHN
TNNHNNNNNTNNNHTNTBTNNTTBHNNNTNNTNTNNNHHNBBHTHNNTTNTNHNHNNTNNBTNNNBTHNNTBHTTTHHHNHTNNBTNNBHHHNNTHTNNN
BNTNNNBNNTTTNNHNTTBTNTTHBTBTNNNNHTNTNHNHNNTNNNTNNNTHNNNNTNBNBNTNNNNTTBNTNNTTNNTNNNNNNHHHNNTNNNNHHNNH
NBNNNNNTHTTTNHNNHNNNNHNNNNNBNNHTTTTHNHNNBNNNNTTHHNBNTNTNNNTNHBNNBTNNTHNNHNTNNNNTBNNTHTNNNNNBTNTTBNNT
